games,L,T,W,conference,division,School,yearID,ch_win,ch_ru
12,8,0,4,FBS Independents,,Amherst College,1900,N,N
11,4,0,7,FBS Independents,,Army,1900,N,N
10,1,0,9,FBS Independents,,Beloit College,1900,N,N
9,2,0,7,FBS Independents,,Bowdoin,1900,N,N
11,4,0,7,FBS Independents,,Brown,1900,N,N
9,5,0,4,FBS Independents,,Bucknell,1900,N,N
11,5,0,6,FBS Independents,,Carlisle,1900,N,N
15,5,0,10,Western,,Chicago,1900,N,N
11,4,0,7,FBS Independents,,Columbia,1900,N,N
12,2,0,10,FBS Independents,,Cornell,1900,N,N
8,5,0,3,FBS Independents,,Dartmouth,1900,N,N
10,5,0,5,FBS Independents,,Dickinson,1900,N,N
9,3,0,6,FBS Independents,,Drake,1900,N,N
9,6,0,3,FBS Independents,,Grinnell,1900,N,N
11,1,0,10,FBS Independents,,Harvard,1900,N,N
10,4,0,6,FBS Independents,,Holy Cross,1900,N,N
12,3,0,9,Western,,Illinois,1900,N,N
8,4,0,4,Western,,Indiana,1900,N,N
8,0,0,8,Western,,Iowa,1900,N,N
8,5,0,3,FBS Independents,,Iowa State,1900,N,N
10,4,0,6,FBS Independents,,Knox College,1900,N,N
11,2,0,9,FBS Independents,,Lafayette,1900,N,N
11,6,0,5,FBS Independents,,Lehigh,1900,N,N
10,3,0,7,Western,,Michigan,1900,N,N
12,2,0,10,Western,,Minnesota,1900,N,N
9,3,0,6,FBS Independents,,Navy,1900,N,N
10,2,0,8,FBS Independents,,Nebraska,1900,N,N
12,5,0,7,Western,,Northwestern,1900,N,N
10,4,0,6,FBS Independents,,Notre Dame,1900,N,N
11,6,0,5,FBS Independents,,Penn State,1900,N,N
11,3,0,8,FBS Independents,,Princeton,1900,N,N
8,4,0,4,Western,,Purdue,1900,N,N
10,2,0,8,FBS Independents,,Syracuse,1900,N,N
8,3,0,5,FBS Independents,,Trinity (CT),1900,N,N
10,7,0,3,FBS Independents,,Tufts,1900,N,N
10,5,0,5,FBS Independents,,UMass,1900,N,N
9,4,0,5,FBS Independents,,Wesleyan (CT),1900,N,N
11,4,0,7,FBS Independents,,Williams,1900,N,N
9,1,0,8,Western,,Wisconsin,1900,N,N
12,0,0,12,FBS Independents,,Yale,1900,Y,N
12,7,0,5,FBS Independents,,Amherst College,1901,N,N
8,3,0,5,FBS Independents,,Army,1901,N,N
6,3,0,3,FBS Independents,,Bates College,1901,N,N
11,4,0,7,FBS Independents,,Beloit College,1901,N,N
9,7,0,2,FBS Independents,,Boston College,1901,N,N
9,7,0,2,FBS Independents,,Bowdoin,1901,N,N
12,8,0,4,FBS Independents,,Brown,1901,N,N
10,4,0,6,FBS Independents,,Bucknell,1901,N,N
13,8,0,5,FBS Independents,,Carlisle,1901,N,N
16,8,0,8,Western,,Chicago,1901,N,N
13,5,0,8,FBS Independents,,Columbia,1901,N,N
12,1,0,11,FBS Independents,,Cornell,1901,N,N
11,1,0,10,FBS Independents,,Dartmouth,1901,N,N
10,6,0,4,FBS Independents,,Dickinson,1901,N,N
8,4,0,4,FBS Independents,,Drake,1901,N,N
9,2,0,7,FBS Independents,,Grinnell,1901,N,N
12,0,0,12,FBS Independents,,Harvard,1901,N,N
9,1,0,8,FBS Independents,,Holy Cross,1901,N,N
10,2,0,8,Western,,Illinois,1901,N,N
9,3,0,6,Western,,Indiana,1901,N,N
9,3,0,6,Western,,Iowa,1901,N,N
10,6,0,4,FBS Independents,,Iowa State,1901,N,N
10,5,0,5,FBS Independents,,Kansas,1901,N,N
12,3,0,9,FBS Independents,,Lafayette,1901,N,N
12,11,0,1,FBS Independents,,Lehigh,1901,N,N
11,0,0,11,Western,,Michigan,1901,Y,N
11,2,0,9,Western,,Minnesota,1901,N,N
8,7,0,1,FBS Independents,,Missouri,1901,N,N
11,5,0,6,FBS Independents,,Navy,1901,N,N
9,2,0,7,FBS Independents,,Nebraska,1901,N,N
11,3,0,8,Western,,Northwestern,1901,N,N
10,2,0,8,FBS Independents,,Notre Dame,1901,N,N
8,3,0,5,FBS Independents,,Penn State,1901,N,N
11,1,0,10,FBS Independents,,Princeton,1901,N,N
9,4,0,5,Western,,Purdue,1901,N,N
9,2,0,7,FBS Independents,,Syracuse,1901,N,N
8,7,0,1,FBS Independents,,Trinity (CT),1901,N,N
13,6,0,7,FBS Independents,,Tufts,1901,N,N
9,1,0,8,FBS Independents,,UMass,1901,N,N
11,5,0,6,FBS Independents,,Vermont,1901,N,N
10,7,0,3,FBS Independents,,Wesleyan (CT),1901,N,N
10,4,0,6,FBS Independents,,Williams,1901,N,N
9,0,0,9,Western,,Wisconsin,1901,N,N
13,1,0,12,FBS Independents,,Yale,1901,N,N
8,4,0,4,FBS Independents,,Alabama,1902,N,N
10,3,0,7,FBS Independents,,Amherst College,1902,N,N
8,2,0,6,FBS Independents,,Army,1902,N,N
7,4,0,3,FBS Independents,,Auburn,1902,N,N
8,5,0,3,FBS Independents,,Beloit College,1902,N,N
9,9,0,0,FBS Independents,,Boston College,1902,N,N
10,5,0,5,FBS Independents,,Brown,1902,N,N
10,4,0,6,FBS Independents,,Bucknell,1902,N,N
11,3,0,8,FBS Independents,,Carlisle,1902,N,N
15,1,0,14,Western,,Chicago,1902,N,N
7,1,0,6,FBS Independents,,Clemson,1902,N,N
6,1,0,5,FBS Independents,,Colorado,1902,N,N
7,4,0,3,FBS Independents,,Colorado College,1902,N,N
7,3,0,4,FBS Independents,,Colorado Mines,1902,N,N
6,3,0,3,FBS Independents,,Colorado State,1902,N,N
11,5,0,6,FBS Independents,,Columbia,1902,N,N
11,3,0,8,FBS Independents,,Cornell,1902,N,N
9,3,0,6,FBS Independents,,Dartmouth,1902,N,N
9,5,0,4,FBS Independents,,Davidson,1902,N,N
8,5,0,3,FBS Independents,,Denver,1902,N,N
10,6,0,4,FBS Independents,,Dickinson,1902,N,N
8,3,0,5,FBS Independents,,Drake,1902,N,N
11,6,0,5,FBS Independents,,Furman,1902,N,N
10,3,0,7,FBS Independents,,Georgetown,1902,N,N
7,2,0,5,FBS Independents,,Georgia,1902,N,N
8,7,0,1,FBS Independents,,Georgia Tech,1902,N,N
11,9,0,2,FBS Independents,,Grinnell,1902,N,N
12,1,0,11,FBS Independents,,Harvard,1902,N,N
11,3,0,8,FBS Independents,,Haskell,1902,N,N
9,3,0,6,FBS Independents,,Holy Cross,1902,N,N
13,2,0,11,Western,,Illinois,1902,N,N
9,5,0,4,Western,,Indiana,1902,N,N
9,4,0,5,Western,,Iowa,1902,N,N
10,3,0,7,FBS Independents,,Iowa State,1902,N,N
10,4,0,6,FBS Independents,,Kansas,1902,N,N
11,2,0,9,FBS Independents,,Knox College,1902,N,N
11,3,0,8,FBS Independents,,Lafayette,1902,N,N
11,3,0,8,FBS Independents,,Lehigh,1902,N,N
7,1,0,6,FBS Independents,,LSU,1902,N,N
11,0,0,11,Western,,Michigan,1902,Y,N
12,3,0,9,Western,,Minnesota,1902,N,N
6,4,0,2,FBS Independents,,Mississippi State,1902,N,N
8,3,0,5,FBS Independents,,Missouri,1902,N,N
10,8,0,2,FBS Independents,,Navy,1902,N,N
9,5,0,4,FBS Independents,,NC State,1902,N,N
10,0,0,10,FBS Independents,,Nebraska,1902,N,N
9,1,0,8,FBS Independents,,North Carolina,1902,N,N
12,6,0,6,Western,,Northwestern,1902,N,N
9,2,0,7,FBS Independents,,Notre Dame,1902,N,N
7,3,0,4,FBS Independents,,Ole Miss,1902,N,N
10,3,0,7,FBS Independents,,Penn State,1902,N,N
9,1,0,8,FBS Independents,,Princeton,1902,N,N
10,3,0,7,Western,,Purdue,1902,N,N
9,2,0,7,FBS Independents,,Sewanee Univ. of the South,1902,N,N
5,3,0,2,FBS Independents,,Simpson College,1902,N,N
9,2,0,7,FBS Independents,,Syracuse,1902,N,N
8,2,0,6,FBS Independents,,Tennessee,1902,N,N
10,4,0,6,FBS Independents,,Texas,1902,N,N
11,6,0,5,FBS Independents,,Tufts,1902,N,N
7,6,0,1,FBS Independents,,Tulane,1902,N,N
7,3,0,4,FBS Independents,,UMass,1902,N,N
6,6,0,0,FBS Independents,,Union (NY),1902,N,N
9,1,0,8,FBS Independents,,Vanderbilt,1902,N,N
10,3,0,7,FBS Independents,,Vermont,1902,N,N
10,2,0,8,FBS Independents,,Virginia,1902,N,N
6,3,0,3,FBS Independents,,Virginia Tech,1902,N,N
9,6,0,3,FBS Independents,,Washington (MO),1902,N,N
10,7,0,3,FBS Independents,,Wesleyan (CT),1902,N,N
10,7,0,3,FBS Independents,,Williams,1902,N,N
9,3,0,6,Western,,Wisconsin,1902,N,N
12,0,0,12,FBS Independents,,Yale,1902,N,N
7,4,0,3,FBS Independents,,Alabama,1903,N,N
10,3,0,7,FBS Independents,,Amherst College,1903,N,N
9,3,0,6,FBS Independents,,Army,1903,N,N
7,3,0,4,FBS Independents,,Auburn,1903,N,N
8,4,0,4,FBS Independents,,Baylor,1903,N,N
10,7,0,3,FBS Independents,,Beloit College,1903,N,N
10,5,0,5,FBS Independents,,Brown,1903,N,N
9,5,0,4,FBS Independents,,Bucknell,1903,N,N
14,2,0,12,FBS Independents,,Carlisle,1903,N,N
15,3,0,12,Western,,Chicago,1903,N,N
6,2,0,4,FBS Independents,,Clemson,1903,N,N
10,2,0,8,FBS Independents,,Colorado,1903,N,N
9,5,0,4,FBS Independents,,Colorado College,1903,N,N
6,3,0,3,FBS Independents,,Colorado Mines,1903,N,N
7,1,0,6,FBS Independents,,Colorado State,1903,N,N
10,1,0,9,FBS Independents,,Columbia,1903,N,N
10,4,0,6,FBS Independents,,Cornell,1903,N,N
9,8,0,1,FBS Independents,,Cornell College (IA),1903,N,N
6,1,0,5,FBS Independents,,Cumberland,1903,N,N
10,1,0,9,FBS Independents,,Dartmouth,1903,N,N
13,7,0,6,FBS Independents,,Denver,1903,N,N
12,5,0,7,FBS Independents,,Dickinson,1903,N,N
8,3,0,5,FBS Independents,,Drake,1903,N,N
10,3,0,7,FBS Independents,,Georgetown,1903,N,N
7,4,0,3,FBS Independents,,Georgia,1903,N,N
7,5,0,2,FBS Independents,,Georgia Tech,1903,N,N
9,4,0,5,FBS Independents,,Grinnell,1903,N,N
12,3,0,9,FBS Independents,,Harvard,1903,N,N
9,2,0,7,FBS Independents,,Haskell,1903,N,N
10,2,0,8,FBS Independents,,Holy Cross,1903,N,N
14,6,0,8,Western,,Illinois,1903,N,N
8,4,0,4,Western,,Indiana,1903,N,N
11,2,0,9,Western,,Iowa,1903,N,N
9,1,0,8,FBS Independents,,Iowa State,1903,N,N
9,3,0,6,FBS Independents,,Kansas,1903,N,N
11,7,0,4,FBS Independents,,Knox College,1903,N,N
10,3,0,7,FBS Independents,,Lafayette,1903,N,N
12,2,0,10,FBS Independents,,Lehigh,1903,N,N
8,3,0,5,FBS Independents,,Lombard,1903,N,N
12,0,0,12,Western,,Michigan,1903,Y,N
15,1,0,14,Western,,Minnesota,1903,N,N
9,7,0,2,FBS Independents,,Missouri,1903,N,N
12,8,0,4,FBS Independents,,Navy,1903,N,N
11,0,0,11,FBS Independents,,Nebraska,1903,N,N
9,3,0,6,FBS Independents,,North Carolina,1903,N,N
14,3,0,11,Western,,Northwestern,1903,N,N
12,6,0,6,FBS Independents,,Oklahoma,1903,N,N
8,3,0,5,FBS Independents,,Penn State,1903,N,N
11,0,0,11,FBS Independents,,Princeton,1903,Y,N
6,2,0,4,Western,,Purdue,1903,N,N
8,1,0,7,FBS Independents,,Sewanee Univ. of the South,1903,N,N
5,4,0,1,FBS Independents,,Simpson College,1903,N,N
10,2,0,8,FBS Independents,,South Carolina,1903,N,N
10,4,0,6,FBS Independents,,Swarthmore,1903,N,N
7,7,0,0,FBS Independents,,TCU,1903,N,N
9,5,0,4,FBS Independents,,Tennessee,1903,N,N
8,3,0,5,FBS Independents,,Texas,1903,N,N
11,3,0,8,FBS Independents,,Texas A&M,1903,N,N
14,9,0,5,FBS Independents,,Tufts,1903,N,N
9,4,0,5,FBS Independents,,UMass,1903,N,N
8,1,0,7,FBS Independents,,Vanderbilt,1903,N,N
9,5,0,4,FBS Independents,,Vermont,1903,N,N
10,3,0,7,FBS Independents,,Virginia,1903,N,N
6,1,0,5,FBS Independents,,Virginia Tech,1903,N,N
9,5,0,4,FBS Independents,,Washington (MO),1903,N,N
10,6,0,4,FBS Independents,,Wesleyan (CT),1903,N,N
11,5,0,6,FBS Independents,,Williams,1903,N,N
10,3,0,7,Western,,Wisconsin,1903,N,N
12,1,0,11,FBS Independents,,Yale,1903,N,N
10,3,0,7,FBS Independents,,Alabama,1904,N,N
10,1,0,9,FBS Independents,,Amherst College,1904,N,N
9,2,0,7,FBS Independents,,Army,1904,N,N
6,0,0,6,FBS Independents,,Auburn,1904,N,N
8,4,0,4,FBS Independents,,Bates College,1904,N,N
8,6,0,2,FBS Independents,,Baylor,1904,N,N
9,5,0,4,FBS Independents,,Beloit College,1904,N,N
9,4,0,5,FBS Independents,,Bowdoin,1904,N,N
11,5,0,6,FBS Independents,,Brown,1904,N,N
6,3,0,3,FBS Independents,,Bucknell,1904,N,N
12,2,0,10,FBS Independents,,Carlisle,1904,N,N
12,2,0,10,Western,,Chicago,1904,N,N
7,3,0,4,FBS Independents,,Clemson,1904,N,N
7,5,0,2,FBS Independents,,Colby,1904,N,N
9,2,0,7,FBS Independents,,Colorado,1904,N,N
10,3,0,7,FBS Independents,,Colorado College,1904,N,N
5,1,0,4,FBS Independents,,Colorado Mines,1904,N,N
5,4,0,1,FBS Independents,,Colorado State,1904,N,N
10,3,0,7,FBS Independents,,Columbia,1904,N,N
10,3,0,7,FBS Independents,,Cornell,1904,N,N
8,0,0,8,FBS Independents,,Dartmouth,1904,N,N
7,5,0,2,FBS Independents,,Denver,1904,N,N
12,3,0,9,FBS Independents,,Dickinson,1904,N,N
9,4,0,5,FBS Independents,,Drake,1904,N,N
5,5,0,0,FBS Independents,,Florida,1904,N,N
10,10,0,0,FBS Independents,,Franklin & Marshall,1904,N,N
8,1,0,7,FBS Independents,,Georgetown,1904,N,N
6,5,0,1,FBS Independents,,Georgia,1904,N,N
10,2,0,8,FBS Independents,,Georgia Tech,1904,N,N
8,7,0,1,FBS Independents,,Grinnell,1904,N,N
10,3,0,7,FBS Independents,,Harvard,1904,N,N
9,1,0,8,FBS Independents,,Haskell,1904,N,N
9,6,0,3,FBS Independents,,Holy Cross,1904,N,N
12,2,0,10,Western,,Illinois,1904,N,N
10,4,0,6,Western,,Indiana,1904,N,N
11,4,0,7,Western,,Iowa,1904,N,N
9,2,0,7,FBS Independents,,Iowa State,1904,N,N
10,2,0,8,FBS Independents,,Kansas,1904,N,N
10,2,0,8,FBS Independents,,Lafayette,1904,N,N
9,8,0,1,FBS Independents,,Lehigh,1904,N,N
7,4,0,3,FBS Independents,,LSU,1904,N,N
8,4,0,4,FBS Independents,,Maine,1904,N,N
10,0,0,10,Western,,Michigan,1904,Y,N
13,0,0,13,Western,,Minnesota,1904,N,N
7,5,0,2,FBS Independents,,Mississippi State,1904,N,N
9,6,0,3,FBS Independents,,Missouri,1904,N,N
9,7,0,2,FBS Independents,,Nashville,1904,N,N
10,3,0,7,FBS Independents,,Navy,1904,N,N
6,2,0,4,FBS Independents,,NC State,1904,N,N
12,3,0,9,FBS Independents,,Nebraska,1904,N,N
7,5,0,2,FBS Independents,,New Hampshire,1904,N,N
9,3,0,6,FBS Independents,,North Carolina,1904,N,N
10,2,0,8,Western,,Northwestern,1904,N,N
8,3,0,5,FBS Independents,,Notre Dame,1904,N,N
11,5,0,6,FBS Independents,,Ohio State,1904,N,N
7,3,0,4,FBS Independents,,Ole Miss,1904,N,N
10,4,0,6,FBS Independents,,Penn State,1904,N,N
10,2,0,8,FBS Independents,,Princeton,1904,N,N
12,3,0,9,Western,,Purdue,1904,N,N
8,1,0,7,FBS Independents,,Sewanee Univ. of the South,1904,N,N
9,3,0,6,FBS Independents,,Swarthmore,1904,N,N
6,4,0,2,FBS Independents,,TCU,1904,N,N
9,6,0,3,FBS Independents,,Tennessee,1904,N,N
6,4,0,2,FBS Independents,,Tennessee Medical College,1904,N,N
8,2,0,6,FBS Independents,,Texas,1904,N,N
6,2,0,4,FBS Independents,,Texas A&M,1904,N,N
13,10,0,3,FBS Independents,,Tufts,1904,N,N
7,2,0,5,FBS Independents,,Tulane,1904,N,N
8,2,0,6,FBS Independents,,UMass,1904,N,N
9,0,0,9,FBS Independents,,Vanderbilt,1904,N,N
7,6,0,1,FBS Independents,,Vermont,1904,N,N
9,3,0,6,FBS Independents,,Virginia,1904,N,N
8,3,0,5,FBS Independents,,Virginia Tech,1904,N,N
9,5,0,4,FBS Independents,,VMI,1904,N,N
8,4,0,4,FBS Independents,,Wabash College,1904,N,N
11,7,0,4,FBS Independents,,Washington (MO),1904,N,N
10,7,0,3,FBS Independents,,Wesleyan (CT),1904,N,N
11,8,0,3,FBS Independents,,Williams,1904,N,N
8,3,0,5,Western,,Wisconsin,1904,N,N
11,1,0,10,FBS Independents,,Yale,1904,N,N
10,4,0,6,FBS Independents,,Alabama,1905,N,N
6,2,0,4,FBS Independents,,Amherst College,1905,N,N
9,5,0,4,FBS Independents,,Army,1905,N,N
6,4,0,2,FBS Independents,,Auburn,1905,N,N
7,3,0,4,FBS Independents,,Bates College,1905,N,N
7,6,0,1,FBS Independents,,Baylor,1905,N,N
10,7,0,3,FBS Independents,,Beloit College,1905,N,N
9,5,0,4,FBS Independents,,Bowdoin,1905,N,N
11,4,0,7,FBS Independents,,Brown,1905,N,N
10,5,0,5,FBS Independents,,Bucknell,1905,N,N
14,4,0,10,FBS Independents,,Carlisle,1905,N,N
11,0,0,11,Western,,Chicago,1905,Y,N
6,3,0,3,FBS Independents,,Clemson,1905,N,N
9,8,0,1,FBS Independents,,Coe,1905,N,N
9,4,0,5,FBS Independents,,Colgate,1905,N,N
9,1,0,8,FBS Independents,,Colorado,1905,N,N
8,2,0,6,FBS Independents,,Colorado College,1905,N,N
6,0,0,6,FBS Independents,,Colorado Mines,1905,N,N
7,4,0,3,FBS Independents,,Colorado State,1905,N,N
9,5,0,4,FBS Independents,,Columbia,1905,N,N
10,4,0,6,FBS Independents,,Cornell,1905,N,N
7,4,0,3,FBS Independents,,Cumberland,1905,N,N
10,1,0,9,FBS Independents,,Dartmouth,1905,N,N
10,7,0,3,FBS Independents,,Denver,1905,N,N
8,4,0,4,FBS Independents,,Dickinson,1905,N,N
8,4,0,4,FBS Independents,,Drake,1905,N,N
9,7,0,2,FBS Independents,,Georgetown,1905,N,N
6,5,0,1,FBS Independents,,Georgia,1905,N,N
7,1,0,6,FBS Independents,,Georgia Tech,1905,N,N
10,2,0,8,FBS Independents,,Grinnell,1905,N,N
11,3,0,8,FBS Independents,,Harvard,1905,N,N
10,4,0,6,FBS Independents,,Haskell,1905,N,N
9,3,0,6,FBS Independents,,Holy Cross,1905,N,N
9,4,0,5,Western,,Illinois,1905,N,N
10,2,0,8,Western,,Indiana,1905,N,N
10,2,0,8,Western,,Iowa,1905,N,N
9,3,0,6,FBS Independents,,Iowa State,1905,N,N
11,1,0,10,FBS Independents,,Kansas,1905,N,N
11,7,0,4,FBS Independents,,Knox College,1905,N,N
10,2,0,8,FBS Independents,,Lafayette,1905,N,N
10,3,0,7,FBS Independents,,Lawrence,1905,N,N
13,7,0,6,FBS Independents,,Lehigh,1905,N,N
8,4,0,4,FBS Independents,,Maine,1905,N,N
13,1,0,12,Western,,Michigan,1905,N,N
11,1,0,10,Western,,Minnesota,1905,N,N
9,4,0,5,FBS Independents,,Missouri,1905,N,N
12,1,0,11,FBS Independents,,Navy,1905,N,N
11,2,0,9,FBS Independents,,Nebraska,1905,N,N
8,4,0,4,FBS Independents,,New Hampshire,1905,N,N
8,3,0,5,FBS Independents,,North Carolina,1905,N,N
11,3,0,8,Western,,Northwestern,1905,N,N
9,4,0,5,FBS Independents,,Notre Dame,1905,N,N
9,2,0,7,FBS Independents,,Oklahoma,1905,N,N
11,3,0,8,FBS Independents,,Penn State,1905,N,N
12,2,0,10,FBS Independents,,Pittsburgh,1905,N,N
10,2,0,8,FBS Independents,,Princeton,1905,N,N
8,1,0,7,Western,,Purdue,1905,N,N
7,2,0,5,FBS Independents,,Sewanee Univ. of the South,1905,N,N
8,1,0,7,FBS Independents,,Swarthmore,1905,N,N
11,3,0,8,FBS Independents,,Syracuse,1905,N,N
8,4,0,4,FBS Independents,,TCU,1905,N,N
9,5,0,4,FBS Independents,,Tennessee,1905,N,N
9,4,0,5,FBS Independents,,Texas,1905,N,N
9,2,0,7,FBS Independents,,Texas A&M,1905,N,N
8,3,0,5,FBS Independents,,Tufts,1905,N,N
10,7,0,3,FBS Independents,,UMass,1905,N,N
8,2,0,6,FBS Independents,,Utah,1905,N,N
8,1,0,7,FBS Independents,,Vanderbilt,1905,N,N
11,5,0,6,FBS Independents,,Vermont,1905,N,N
10,7,0,3,FBS Independents,,Villanova,1905,N,N
9,4,0,5,FBS Independents,,Virginia,1905,N,N
10,1,0,9,FBS Independents,,Virginia Tech,1905,N,N
9,5,0,4,FBS Independents,,Wabash College,1905,N,N
10,3,0,7,FBS Independents,,Washburn,1905,N,N
12,3,0,9,FBS Independents,,Washington & Jefferson,1905,N,N
10,3,0,7,FBS Independents,,Washington (MO),1905,N,N
10,2,0,8,FBS Independents,,Wesleyan (CT),1905,N,N
11,5,0,6,FBS Independents,,Williams,1905,N,N
10,2,0,8,Western,,Wisconsin,1905,N,N
7,4,0,3,FBS Independents,,Wyoming,1905,N,N
10,0,0,10,FBS Independents,,Yale,1905,N,N
6,1,0,5,FBS Independents,,Alabama,1906,N,N
7,3,0,4,FBS Independents,,Amherst College,1906,N,N
8,5,0,3,FBS Independents,,Arkansas,1906,N,N
9,6,0,3,FBS Independents,,Army,1906,N,N
7,6,0,1,FBS Independents,,Auburn,1906,N,N
9,3,0,6,FBS Independents,,Brown,1906,N,N
8,4,0,4,FBS Independents,,Bucknell,1906,N,N
12,3,0,9,FBS Independents,,Carlisle,1906,N,N
5,1,0,4,Western,,Chicago,1906,N,N
7,2,0,5,FBS Independents,,Clemson,1906,N,N
8,2,0,6,FBS Independents,,Colgate,1906,N,N
9,5,0,4,FBS Independents,,Colorado,1906,N,N
7,4,0,3,FBS Independents,,Colorado College,1906,N,N
5,0,0,5,FBS Independents,,Colorado Mines,1906,N,N
11,2,0,9,FBS Independents,,Cornell,1906,N,N
10,3,0,7,FBS Independents,,Dartmouth,1906,N,N
7,4,0,3,FBS Independents,,Davidson,1906,N,N
5,3,0,2,FBS Independents,,Denver,1906,N,N
9,4,0,5,FBS Independents,,Dickinson,1906,N,N
7,4,0,3,FBS Independents,,Drake,1906,N,N
7,5,0,2,FBS Independents,,Georgia,1906,N,N
9,4,0,5,FBS Independents,,Georgia Tech,1906,N,N
11,1,0,10,FBS Independents,,Harvard,1906,N,N
7,5,0,2,FBS Independents,,Haskell,1906,N,N
8,3,0,5,FBS Independents,,Holy Cross,1906,N,N
5,4,0,1,Western,,Illinois,1906,N,N
6,2,0,4,Western,,Indiana,1906,N,N
5,3,0,2,Western,,Iowa,1906,N,N
10,1,0,9,FBS Independents,,Iowa State,1906,N,N
11,3,0,8,FBS Independents,,Kansas,1906,N,N
10,1,0,9,FBS Independents,,Lafayette,1906,N,N
11,6,0,5,FBS Independents,,Lehigh,1906,N,N
6,3,0,3,FBS Independents,,LSU,1906,N,N
8,3,0,5,FBS Independents,,Maryville TN,1906,N,N
5,1,0,4,Western,,Michigan,1906,N,N
5,1,0,4,Western,,Minnesota,1906,N,N
5,3,0,2,FBS Independents,,Mississippi State,1906,N,N
8,2,0,6,FBS Independents,,Missouri,1906,N,N
12,4,0,8,FBS Independents,,Navy,1906,N,N
10,4,0,6,FBS Independents,,Nebraska,1906,N,N
7,4,0,3,FBS Independents,,North Carolina,1906,N,N
6,2,0,4,FBS Independents,,Ole Miss,1906,N,N
10,2,0,8,FBS Independents,,Penn State,1906,N,N
10,4,0,6,FBS Independents,,Pittsburgh,1906,N,N
10,1,0,9,FBS Independents,,Princeton,1906,Y,N
5,5,0,0,Western,,Purdue,1906,N,N
9,1,0,8,FBS Independents,,Sewanee Univ. of the South,1906,N,N
9,2,0,7,FBS Independents,,Swarthmore,1906,N,N
9,3,0,6,FBS Independents,,Syracuse,1906,N,N
7,5,0,2,FBS Independents,,TCU,1906,N,N
9,6,0,3,FBS Independents,,Tennessee,1906,N,N
10,1,0,9,FBS Independents,,Texas,1906,N,N
7,1,0,6,FBS Independents,,Texas A&M,1906,N,N
5,5,0,0,FBS Independents,,Tulane,1906,N,N
9,7,0,2,FBS Independents,,UMass,1906,N,N
5,1,0,4,FBS Independents,,Utah,1906,N,N
9,1,0,8,FBS Independents,,Vanderbilt,1906,N,N
10,7,0,3,FBS Independents,,Villanova,1906,N,N
9,3,0,6,FBS Independents,,Virginia Tech,1906,N,N
11,2,0,9,FBS Independents,,Washington & Jefferson,1906,N,N
9,4,0,5,FBS Independents,,Williams,1906,N,N
5,0,0,5,Western,,Wisconsin,1906,N,N
10,0,0,10,FBS Independents,,Yale,1906,N,N
8,3,0,5,FBS Independents,,Alabama,1907,N,N
9,5,0,4,FBS Independents,,Arkansas,1907,N,N
9,3,0,6,FBS Independents,,Army,1907,N,N
9,2,0,7,FBS Independents,,Auburn,1907,N,N
8,4,0,4,FBS Independents,,Baylor,1907,N,N
10,3,0,7,FBS Independents,,Brown,1907,N,N
11,7,0,4,FBS Independents,,Bucknell,1907,N,N
11,1,0,10,FBS Independents,,Carlisle,1907,N,N
5,1,0,4,Western,,Chicago,1907,N,N
8,4,0,4,FBS Independents,,Clemson,1907,N,N
9,4,0,5,FBS Independents,,Colgate,1907,N,N
8,3,0,5,FBS Independents,,Colorado,1907,N,N
7,2,0,5,FBS Independents,,Colorado College,1907,N,N
6,1,0,5,FBS Independents,,Colorado Mines,1907,N,N
10,2,0,8,FBS Independents,,Cornell,1907,N,N
6,1,0,5,FBS Independents,,Davidson,1907,N,N
8,6,0,2,FBS Independents,,Denver,1907,N,N
10,7,0,3,FBS Independents,,Dickinson,1907,N,N
8,5,0,3,FBS Independents,,Drake,1907,N,N
5,4,0,1,FBS Independents,,Drury,1907,N,N
8,3,0,5,FBS Independents,,Georgia,1907,N,N
8,4,0,4,FBS Independents,,Georgia Tech,1907,N,N
9,3,0,6,FBS Independents,,Grinnell,1907,N,N
5,4,0,1,FBS Independents,,Hamilton,1907,N,N
10,3,0,7,FBS Independents,,Harvard,1907,N,N
9,6,0,3,FBS Independents,,Haskell,1907,N,N
5,2,0,3,Western,,Illinois,1907,N,N
6,3,0,3,Western,,Indiana,1907,N,N
5,2,0,3,Western,,Iowa,1907,N,N
8,2,0,6,FBS Independents,,Iowa State,1907,N,N
8,3,0,5,Missouri Valley,,Kansas,1907,N,N
10,2,0,8,FBS Independents,,Lafayette,1907,N,N
10,2,0,8,FBS Independents,,Lehigh,1907,N,N
10,3,0,7,FBS Independents,,LSU,1907,N,N
5,5,0,0,FBS Independents,,Maryville TN,1907,N,N
6,1,0,5,FBS Independents,,Michigan,1907,N,N
5,2,0,3,Western,,Minnesota,1907,N,N
9,3,0,6,FBS Independents,,Mississippi State,1907,N,N
9,2,0,7,Missouri Valley,,Missouri,1907,N,N
12,3,0,9,FBS Independents,,Navy,1907,N,N
10,2,0,8,Missouri Valley,,Nebraska,1907,N,N
9,5,0,4,FBS Independents,,North Carolina,1907,N,N
6,6,0,0,FBS Independents,,Ole Miss,1907,N,N
10,4,0,6,FBS Independents,,Penn State,1907,N,N
10,2,0,8,FBS Independents,,Pittsburgh,1907,N,N
9,2,0,7,FBS Independents,,Princeton,1907,N,N
5,5,0,0,Western,,Purdue,1907,N,N
10,3,0,7,FBS Independents,,Saint Louis,1907,N,N
7,5,0,2,FBS Independents,,Samford,1907,N,N
9,1,0,8,FBS Independents,,Sewanee Univ. of the South,1907,N,N
8,2,0,6,FBS Independents,,Swarthmore,1907,N,N
9,4,0,5,FBS Independents,,Syracuse,1907,N,N
8,2,0,6,FBS Independents,,TCU,1907,N,N
10,3,0,7,FBS Independents,,Tennessee,1907,N,N
8,2,0,6,FBS Independents,,Texas,1907,N,N
8,1,0,7,FBS Independents,,Texas A&M,1907,N,N
5,2,0,3,FBS Independents,,Tulane,1907,N,N
9,3,0,6,FBS Independents,,Utah,1907,N,N
7,1,0,6,FBS Independents,,Vanderbilt,1907,N,N
7,5,0,2,FBS Independents,,Villanova,1907,N,N
10,4,0,6,FBS Independents,,Virginia,1907,N,N
9,2,0,7,FBS Independents,,Virginia Tech,1907,N,N
9,2,0,7,FBS Independents,,Washington & Jefferson,1907,N,N
6,2,0,4,FBS Independents,,Washington & Lee,1907,N,N
6,5,0,1,Missouri Valley,,Washington (MO),1907,N,N
5,2,0,3,Western,,Wisconsin,1907,N,N
10,0,0,10,FBS Independents,,Yale,1907,Y,N
8,2,0,6,FBS Independents,,Alabama,1908,N,N
9,4,0,5,FBS Independents,,Arkansas,1908,N,N
9,3,0,6,FBS Independents,,Army,1908,N,N
7,1,0,6,FBS Independents,,Auburn,1908,N,N
8,5,0,3,FBS Independents,,Baylor,1908,N,N
9,3,0,6,FBS Independents,,Brown,1908,N,N
10,5,0,5,FBS Independents,,Bucknell,1908,N,N
13,2,0,11,FBS Independents,,Carlisle,1908,N,N
6,1,0,5,Western,,Chicago,1908,N,N
7,6,0,1,FBS Independents,,Clemson,1908,N,N
7,3,0,4,FBS Independents,,Colgate,1908,N,N
7,2,0,5,FBS Independents,,Colorado,1908,N,N
7,2,0,5,FBS Independents,,Colorado College,1908,N,N
5,3,0,2,FBS Independents,,Colorado Mines,1908,N,N
9,1,0,8,FBS Independents,,Cornell,1908,N,N
10,4,0,6,FBS Independents,,Davidson,1908,N,N
8,1,0,7,FBS Independents,,Denver,1908,N,N
9,4,0,5,FBS Independents,,Dickinson,1908,N,N
8,2,0,6,Missouri Valley,,Drake,1908,N,N
7,5,0,2,FBS Independents,,Georgetown,1908,N,N
10,2,0,8,FBS Independents,,George Washington,1908,N,N
8,2,0,6,FBS Independents,,Georgia,1908,N,N
9,3,0,6,FBS Independents,,Georgia Tech,1908,N,N
10,0,0,10,FBS Independents,,Harvard,1908,N,N
9,5,0,4,FBS Independents,,Haskell,1908,N,N
7,2,0,5,Western,,Illinois,1908,N,N
7,4,0,3,Western,,Indiana,1908,N,N
7,5,0,2,Western,,Iowa,1908,N,N
9,3,0,6,Missouri Valley,,Iowa State,1908,N,N
9,0,0,9,Missouri Valley,,Kansas,1908,N,N
10,3,0,7,FBS Independents,,Lafayette,1908,N,N
7,3,0,4,FBS Independents,,Lehigh,1908,N,N
10,0,0,10,FBS Independents,,LSU,1908,Y,N
8,2,0,6,FBS Independents,,Michigan,1908,N,N
6,3,0,3,Western,,Minnesota,1908,N,N
7,4,0,3,FBS Independents,,Mississippi State,1908,N,N
8,2,0,6,Missouri Valley,,Missouri,1908,N,N
12,3,0,9,FBS Independents,,Navy,1908,N,N
7,1,0,6,FBS Independents,,NC State,1908,N,N
10,2,0,8,Missouri Valley,,Nebraska,1908,N,N
9,4,0,5,FBS Independents,,North Carolina,1908,N,N
4,2,0,2,Western,,Northwestern,1908,N,N
8,5,0,3,FBS Independents,,Ole Miss,1908,N,N
10,5,0,5,FBS Independents,,Penn State,1908,N,N
11,3,0,8,FBS Independents,,Pittsburgh,1908,N,N
10,4,0,6,FBS Independents,,Princeton,1908,N,N
7,3,0,4,Western,,Purdue,1908,N,N
10,3,0,7,FBS Independents,,Saint Louis,1908,N,N
8,1,0,7,FBS Independents,,Sewanee Univ. of the South,1908,N,N
10,3,0,7,FBS Independents,,Syracuse,1908,N,N
9,3,0,6,FBS Independents,,TCU,1908,N,N
9,2,0,7,FBS Independents,,Tennessee,1908,N,N
9,4,0,5,FBS Independents,,Texas,1908,N,N
8,5,0,3,FBS Independents,,Texas A&M,1908,N,N
8,1,0,7,FBS Independents,,Tulane,1908,N,N
6,3,0,3,FBS Independents,,Utah,1908,N,N
10,3,0,7,FBS Independents,,Vanderbilt,1908,N,N
7,6,0,1,FBS Independents,,Villanova,1908,N,N
8,1,0,7,FBS Independents,,Virginia,1908,N,N
9,4,0,5,FBS Independents,,Virginia Tech,1908,N,N
6,5,0,1,FBS Independents,,Wake Forest,1908,N,N
13,2,0,11,FBS Independents,,Washington & Jefferson,1908,N,N
8,2,0,6,FBS Independents,,Washington & Lee,1908,N,N
9,4,0,5,Missouri Valley,,Washington (MO),1908,N,N
6,1,0,5,Western,,Wisconsin,1908,N,N
9,2,0,7,FBS Independents,,Yale,1908,N,N
8,1,0,7,FBS Independents,,Alabama,1909,N,N
7,0,0,7,FBS Independents,,Arkansas,1909,N,N
5,2,0,3,FBS Independents,,Army,1909,N,N
7,2,0,5,FBS Independents,,Auburn,1909,N,N
8,3,0,5,FBS Independents,,Baylor,1909,N,N
10,3,0,7,FBS Independents,,Brown,1909,N,N
9,5,0,4,FBS Independents,,Bucknell,1909,N,N
12,4,0,8,FBS Independents,,Carlisle,1909,N,N
7,5,0,2,FBS Independents,,Chattanooga,1909,N,N
7,2,0,5,Western,,Chicago,1909,N,N
9,3,0,6,FBS Independents,,Clemson,1909,N,N
8,3,0,5,FBS Independents,,Colgate,1909,N,N
6,0,0,6,FBS Independents,,Colorado,1909,N,N
7,2,0,5,FBS Independents,,Colorado College,1909,N,N
6,3,0,3,FBS Independents,,Colorado Mines,1909,N,N
8,5,0,3,FBS Independents,,Cornell,1909,N,N
9,4,0,5,FBS Independents,,Davidson,1909,N,N
9,2,0,7,FBS Independents,,Denver,1909,N,N
9,4,0,5,FBS Independents,,Dickinson,1909,N,N
8,1,0,7,Missouri Valley,,Drake,1909,N,N
8,3,0,5,FBS Independents,,Fordham,1909,N,N
6,2,0,4,FBS Independents,,Georgetown,1909,N,N
7,5,0,2,FBS Independents,,Georgia,1909,N,N
9,2,0,7,FBS Independents,,Georgia Tech,1909,N,N
9,1,0,8,FBS Independents,,Harvard,1909,N,N
9,2,0,7,FBS Independents,,Haskell,1909,N,N
7,2,0,5,Western,,Illinois,1909,N,N
7,3,0,4,Western,,Indiana,1909,N,N
7,4,0,3,Western,,Iowa,1909,N,N
8,4,0,4,Missouri Valley,,Iowa State,1909,N,N
9,1,0,8,Missouri Valley,,Kansas,1909,N,N
8,0,0,8,FBS Independents,,Lafayette,1909,N,N
9,5,0,4,FBS Independents,,Lehigh,1909,N,N
8,2,0,6,FBS Independents,,LSU,1909,N,N
7,4,0,3,FBS Independents,,Mercer,1909,N,N
7,1,0,6,FBS Independents,,Michigan,1909,N,N
7,1,0,6,Western,,Minnesota,1909,N,N
9,4,0,5,FBS Independents,,Mississippi State,1909,N,N
8,0,0,8,Missouri Valley,,Missouri,1909,N,N
8,4,0,4,FBS Independents,,Navy,1909,N,N
7,1,0,6,FBS Independents,,NC State,1909,N,N
8,5,0,3,Missouri Valley,,Nebraska,1909,N,N
7,2,0,5,FBS Independents,,North Carolina,1909,N,N
5,4,0,1,Western,,Northwestern,1909,N,N
10,4,0,6,FBS Independents,,Oklahoma,1909,N,N
9,4,0,5,FBS Independents,,Ole Miss,1909,N,N
7,0,0,7,FBS Independents,,Penn State,1909,N,N
9,2,0,7,FBS Independents,,Pittsburgh,1909,N,N
9,2,0,7,FBS Independents,,Princeton,1909,N,N
7,5,0,2,Western,,Purdue,1909,N,N
10,7,0,3,FBS Independents,,Richmond,1909,N,N
8,2,0,6,FBS Independents,,Samford,1909,N,N
7,1,0,6,FBS Independents,,Sewanee Univ. of the South,1909,N,N
8,6,0,2,FBS Independents,,South Carolina,1909,N,N
10,5,0,5,FBS Independents,,Syracuse,1909,N,N
8,2,0,6,FBS Independents,,TCU,1909,N,N
9,7,0,2,FBS Independents,,Tennessee,1909,N,N
8,3,0,5,FBS Independents,,Texas,1909,N,N
8,1,0,7,FBS Independents,,Texas A&M,1909,N,N
9,5,0,4,FBS Independents,,The Citadel,1909,N,N
9,5,0,4,FBS Independents,,Tulane,1909,N,N
10,3,0,7,FBS Independents,,Vanderbilt,1909,N,N
5,2,0,3,FBS Independents,,Villanova,1909,N,N
8,1,0,7,FBS Independents,,Virginia,1909,N,N
7,1,0,6,FBS Independents,,Virginia Tech,1909,N,N
6,4,0,2,FBS Independents,,Wake Forest,1909,N,N
10,1,0,9,FBS Independents,,Washington & Jefferson,1909,N,N
7,3,0,4,FBS Independents,,Washington & Lee,1909,N,N
7,4,0,3,Missouri Valley,,Washington (MO),1909,N,N
9,5,0,4,FBS Independents,,West Virginia,1909,N,N
5,1,0,4,Western,,Wisconsin,1909,N,N
8,5,0,3,FBS Independents,,Wyoming,1909,N,N
10,0,0,10,FBS Independents,,Yale,1909,Y,N
8,4,0,4,FBS Independents,,Alabama,1910,N,N
8,1,0,7,FBS Independents,,Arkansas,1910,N,N
8,2,0,6,FBS Independents,,Army,1910,N,N
7,1,0,6,FBS Independents,,Auburn,1910,N,N
8,1,0,7,FBS Independents,,Baylor,1910,N,N
10,3,0,7,FBS Independents,,Brown,1910,N,N
8,6,0,2,FBS Independents,,Bucknell,1910,N,N
14,6,0,8,FBS Independents,,Carlisle,1910,N,N
8,7,0,1,FBS Independents,,Carnegie Mellon,1910,N,N
8,2,0,6,FBS Independents,,Chattanooga,1910,N,N
7,5,0,2,Western,,Chicago,1910,N,N
8,4,0,4,FBS Independents,,Clemson,1910,N,N
7,2,0,5,FBS Independents,,Colgate,1910,N,N
6,0,0,6,Rocky Mountain,,Colorado,1910,N,N
7,0,0,7,Rocky Mountain,,Colorado College,1910,N,N
6,4,0,2,Rocky Mountain,,Colorado Mines,1910,N,N
5,5,0,0,Rocky Mountain,,Colorado State,1910,N,N
8,3,0,5,FBS Independents,,Cornell,1910,N,N
8,2,0,6,FBS Independents,,Davidson,1910,N,N
8,4,0,4,Rocky Mountain,,Denver,1910,N,N
10,7,0,3,FBS Independents,,Dickinson,1910,N,N
8,5,0,3,Missouri Valley,,Drake,1910,N,N
8,1,0,7,FBS Independents,,Georgetown,1910,N,N
9,2,0,7,FBS Independents,,Georgia,1910,N,N
8,3,0,5,FBS Independents,,Georgia Tech,1910,N,N
9,0,0,9,FBS Independents,,Harvard,1910,Y,N
9,7,0,2,FBS Independents,,Haskell,1910,N,N
7,0,0,7,Western,,Illinois,1910,N,N
7,1,0,6,Western,,Indiana,1910,N,N
7,2,0,5,Western,,Iowa,1910,N,N
8,4,0,4,Missouri Valley,,Iowa State,1910,N,N
8,2,0,6,Missouri Valley,,Kansas,1910,N,N
9,2,0,7,FBS Independents,,Lafayette,1910,N,N
9,6,0,3,FBS Independents,,Lehigh,1910,N,N
6,5,0,1,FBS Independents,,LSU,1910,N,N
9,3,0,6,FBS Independents,,Mercer,1910,N,N
6,1,0,5,FBS Independents,,Michigan,1910,N,N
7,1,0,6,Western,,Minnesota,1910,N,N
9,2,0,7,FBS Independents,,Mississippi State,1910,N,N
8,3,0,5,Missouri Valley,,Missouri,1910,N,N
9,1,0,8,FBS Independents,,Navy,1910,N,N
6,2,0,4,FBS Independents,,NC State,1910,N,N
8,1,0,7,Missouri Valley,,Nebraska,1910,N,N
9,6,0,3,FBS Independents,,North Carolina,1910,N,N
5,3,0,2,Western,,Northwestern,1910,N,N
8,1,0,7,FBS Independents,,Ole Miss,1910,N,N
8,3,0,5,FBS Independents,,Penn State,1910,N,N
9,0,0,9,FBS Independents,,Pittsburgh,1910,Y,N
8,1,0,7,FBS Independents,,Princeton,1910,N,N
6,5,0,1,Western,,Purdue,1910,N,N
8,7,0,1,FBS Independents,,Samford,1910,N,N
10,2,0,8,FBS Independents,,Sewanee Univ. of the South,1910,N,N
8,4,0,4,FBS Independents,,South Carolina,1910,N,N
6,4,0,2,FBS Independents,,Southwestern University,1910,N,N
10,5,0,5,FBS Independents,,Syracuse,1910,N,N
9,7,0,2,FBS Independents,,TCU,1910,N,N
9,6,0,3,FBS Independents,,Tennessee,1910,N,N
8,2,0,6,FBS Independents,,Texas,1910,N,N
9,1,0,8,FBS Independents,,Texas A&M,1910,N,N
7,4,0,3,FBS Independents,,The Citadel,1910,N,N
7,7,0,0,FBS Independents,,Tulane,1910,N,N
6,2,0,4,Rocky Mountain,,Utah,1910,N,N
9,0,0,9,FBS Independents,,Vanderbilt,1910,N,N
6,4,0,2,FBS Independents,,Villanova,1910,N,N
8,2,0,6,FBS Independents,,Virginia,1910,N,N
8,2,0,6,FBS Independents,,Virginia Tech,1910,N,N
9,7,0,2,FBS Independents,,Wake Forest,1910,N,N
7,3,0,4,FBS Independents,,Washington & Jefferson,1910,N,N
7,3,0,4,FBS Independents,,Washington & Lee,1910,N,N
7,4,0,3,Missouri Valley,,Washington (MO),1910,N,N
5,4,0,1,Western,,Wisconsin,1910,N,N
8,4,0,4,Rocky Mountain,,Wyoming,1910,N,N
10,4,0,6,FBS Independents,,Yale,1910,N,N
9,2,0,7,FBS Independents,,Alabama,1911,N,N
9,2,0,7,FBS Independents,,Arkansas,1911,N,N
8,2,0,6,FBS Independents,,Army,1911,N,N
7,2,0,5,FBS Independents,,Auburn,1911,N,N
9,5,0,4,FBS Independents,,Baylor,1911,N,N
11,4,0,7,FBS Independents,,Brown,1911,N,N
10,3,0,7,FBS Independents,,Bucknell,1911,N,N
12,1,0,11,FBS Independents,,Carlisle,1911,N,N
7,1,0,6,Western,,Chicago,1911,N,N
8,5,0,3,FBS Independents,,Clemson,1911,N,N
9,6,0,3,FBS Independents,,Colgate,1911,N,N
6,0,0,6,Rocky Mountain,,Colorado,1911,N,N
7,3,0,4,Rocky Mountain,,Colorado College,1911,N,N
7,5,0,2,Rocky Mountain,,Colorado Mines,1911,N,N
6,6,0,0,Rocky Mountain,,Colorado State,1911,N,N
10,3,0,7,FBS Independents,,Cornell,1911,N,N
8,3,0,5,FBS Independents,,Davidson,1911,N,N
8,3,0,5,Rocky Mountain,,Denver,1911,N,N
8,3,0,5,Missouri Valley,,Drake,1911,N,N
6,0,0,6,FBS Independents,,Florida,1911,N,N
9,1,0,8,FBS Independents,,Georgetown,1911,N,N
9,2,0,7,FBS Independents,,Georgia,1911,N,N
9,3,0,6,FBS Independents,,Georgia Tech,1911,N,N
9,3,0,6,FBS Independents,,Harvard,1911,N,N
7,2,0,5,Western,,Illinois,1911,N,N
7,4,0,3,Western,,Indiana,1911,N,N
7,4,0,3,Western,,Iowa,1911,N,N
8,2,0,6,Missouri Valley,,Iowa State,1911,N,N
8,3,0,5,Missouri Valley,,Kansas,1911,N,N
10,2,0,8,FBS Independents,,Lafayette,1911,N,N
11,5,0,6,FBS Independents,,Lehigh,1911,N,N
9,3,0,6,FBS Independents,,LSU,1911,N,N
10,5,0,5,FBS Independents,,Mercer,1911,N,N
8,2,0,6,FBS Independents,,Michigan,1911,N,N
7,0,0,7,Western,,Minnesota,1911,N,N
6,5,0,1,FBS Independents,,Mississippi College,1911,N,N
10,3,0,7,FBS Independents,,Mississippi State,1911,N,N
8,5,0,3,Missouri Valley,,Missouri,1911,N,N
9,3,0,6,FBS Independents,,Navy,1911,N,N
8,3,0,5,FBS Independents,,NC State,1911,N,N
8,2,0,6,Missouri Valley,,Nebraska,1911,N,N
8,1,0,7,FBS Independents,,North Carolina,1911,N,N
7,4,0,3,Western,,Northwestern,1911,N,N
9,3,0,6,FBS Independents,,Ole Miss,1911,N,N
9,0,0,9,FBS Independents,,Penn State,1911,Y,N
8,4,0,4,FBS Independents,,Pittsburgh,1911,N,N
10,1,0,9,FBS Independents,,Princeton,1911,Y,N
7,4,0,3,Western,,Purdue,1911,N,N
8,6,0,2,FBS Independents,,Samford,1911,N,N
10,4,0,6,FBS Independents,,Sewanee Univ. of the South,1911,N,N
7,5,0,2,FBS Independents,,South Carolina,1911,N,N
6,4,0,2,FBS Independents,,Southwestern University,1911,N,N
10,3,0,7,FBS Independents,,Syracuse,1911,N,N
9,5,0,4,FBS Independents,,Tennessee,1911,N,N
7,2,0,5,FBS Independents,,Texas,1911,N,N
7,1,0,6,FBS Independents,,Texas A&M,1911,N,N
9,3,0,6,FBS Independents,,The Citadel,1911,N,N
9,4,0,5,FBS Independents,,Tulane,1911,N,N
7,1,0,6,Rocky Mountain,,Utah,1911,N,N
9,1,0,8,FBS Independents,,Vanderbilt,1911,N,N
6,5,0,1,FBS Independents,,Villanova,1911,N,N
10,2,0,8,FBS Independents,,Virginia,1911,N,N
9,3,0,6,FBS Independents,,Virginia Tech,1911,N,N
8,5,0,3,FBS Independents,,Wake Forest,1911,N,N
10,4,0,6,FBS Independents,,Washington & Jefferson,1911,N,N
8,2,0,6,FBS Independents,,Washington & Lee,1911,N,N
8,3,0,5,Missouri Valley,,Washington (MO),1911,N,N
7,2,0,5,Western,,Wisconsin,1911,N,N
8,3,0,5,Rocky Mountain,,Wyoming,1911,N,N
10,2,0,8,FBS Independents,,Yale,1911,N,N
9,4,0,5,FBS Independents,,Alabama,1912,N,N
10,6,0,4,FBS Independents,,Arkansas,1912,N,N
8,3,0,5,FBS Independents,,Army,1912,N,N
8,2,0,6,FBS Independents,,Auburn,1912,N,N
8,5,0,3,FBS Independents,,Baylor,1912,N,N
10,4,0,6,FBS Independents,,Brown,1912,N,N
10,3,0,7,FBS Independents,,Bucknell,1912,N,N
14,1,0,13,FBS Independents,,Carlisle,1912,N,N
7,1,0,6,Western,,Chicago,1912,N,N
8,4,0,4,FBS Independents,,Clemson,1912,N,N
7,2,0,5,FBS Independents,,Colgate,1912,N,N
9,3,0,6,Rocky Mountain,,Colorado,1912,N,N
9,4,0,5,Rocky Mountain,,Colorado College,1912,N,N
10,1,0,9,Rocky Mountain,,Colorado Mines,1912,N,N
5,2,0,3,Rocky Mountain,,Colorado State,1912,N,N
10,7,0,3,FBS Independents,,Cornell,1912,N,N
9,2,0,7,FBS Independents,,Dartmouth,1912,N,N
7,4,0,3,FBS Independents,,Davidson,1912,N,N
9,7,0,2,Rocky Mountain,,Denver,1912,N,N
8,3,0,5,Missouri Valley,,Drake,1912,N,N
8,3,0,5,FBS Independents,,Florida,1912,N,N
9,1,0,8,FBS Independents,,Georgetown,1912,N,N
8,2,0,6,FBS Independents,,Georgia,1912,N,N
9,4,0,5,FBS Independents,,Georgia Tech,1912,N,N
9,0,0,9,FBS Independents,,Harvard,1912,Y,N
7,3,0,4,Western,,Illinois,1912,N,N
7,5,0,2,Western,,Indiana,1912,N,N
7,3,0,4,Western,,Iowa,1912,N,N
8,2,0,6,Missouri Valley,,Iowa State,1912,N,N
8,4,0,4,Missouri Valley,,Kansas,1912,N,N
10,2,0,8,FBS Independents,,Kansas State,1912,N,N
10,6,0,4,FBS Independents,,Lafayette,1912,N,N
11,2,0,9,FBS Independents,,Lehigh,1912,N,N
7,3,0,4,FBS Independents,,LSU,1912,N,N
9,3,0,6,FBS Independents,,Mercer,1912,N,N
7,2,0,5,FBS Independents,,Michigan,1912,N,N
7,3,0,4,Western,,Minnesota,1912,N,N
7,4,0,3,FBS Independents,,Mississippi College,1912,N,N
7,3,0,4,FBS Independents,,Mississippi State,1912,N,N
8,3,0,5,Missouri Valley,,Missouri,1912,N,N
9,3,0,6,FBS Independents,,Navy,1912,N,N
7,3,0,4,FBS Independents,,NC State,1912,N,N
8,1,0,7,Missouri Valley,,Nebraska,1912,N,N
8,5,0,3,FBS Independents,,North Carolina,1912,N,N
6,4,0,2,Western,,Northwestern,1912,N,N
9,4,0,5,FBS Independents,,Oklahoma,1912,N,N
7,3,0,4,FBS Independents,,Ole Miss,1912,N,N
8,0,0,8,FBS Independents,,Penn State,1912,Y,N
9,6,0,3,FBS Independents,,Pittsburgh,1912,N,N
9,2,0,7,FBS Independents,,Princeton,1912,N,N
7,3,0,4,Western,,Purdue,1912,N,N
7,6,0,1,FBS Independents,,Samford,1912,N,N
8,1,0,7,FBS Independents,,Sewanee Univ. of the South,1912,N,N
8,2,0,6,FBS Independents,,South Carolina,1912,N,N
6,3,0,3,FBS Independents,,Southwestern University,1912,N,N
9,1,0,8,FBS Independents,,Swarthmore,1912,N,N
9,5,0,4,FBS Independents,,Syracuse,1912,N,N
8,4,0,4,FBS Independents,,Tennessee,1912,N,N
8,1,0,7,FBS Independents,,Texas,1912,N,N
9,1,0,8,FBS Independents,,Texas A&M,1912,N,N
6,4,0,2,FBS Independents,,The Citadel,1912,N,N
8,3,0,5,FBS Independents,,Tulane,1912,N,N
7,2,0,5,Rocky Mountain,,Utah,1912,N,N
7,2,0,5,FBS Independents,,Utah State,1912,N,N
10,1,0,9,FBS Independents,,Vanderbilt,1912,N,N
6,3,0,3,FBS Independents,,Villanova,1912,N,N
9,3,0,6,FBS Independents,,Virginia,1912,N,N
9,4,0,5,FBS Independents,,Virginia Tech,1912,N,N
8,6,0,2,FBS Independents,,Wake Forest,1912,N,N
12,4,0,8,FBS Independents,,Washington & Jefferson,1912,N,N
9,1,0,8,FBS Independents,,Washington & Lee,1912,N,N
8,4,0,4,Missouri Valley,,Washington (MO),1912,N,N
7,0,0,7,Western,,Wisconsin,1912,N,N
9,7,0,2,Rocky Mountain,,Wyoming,1912,N,N
9,1,0,8,FBS Independents,,Yale,1912,N,N
9,3,0,6,FBS Independents,,Alabama,1913,N,N
9,2,0,7,FBS Independents,,Arkansas,1913,N,N
9,1,0,8,FBS Independents,,Army,1913,N,N
8,0,0,8,FBS Independents,,Auburn,1913,N,N
10,5,0,5,FBS Independents,,Baylor,1913,N,N
9,5,0,4,FBS Independents,,Brown,1913,N,N
10,4,0,6,FBS Independents,,Bucknell,1913,N,N
12,1,0,11,FBS Independents,,Carlisle,1913,N,N
7,0,0,7,Western,,Chicago,1913,N,N
8,4,0,4,FBS Independents,,Clemson,1913,N,N
8,1,0,7,FBS Independents,,Colgate,1913,N,N
7,2,0,5,Rocky Mountain,,Colorado,1913,N,N
8,2,0,6,Rocky Mountain,,Colorado College,1913,N,N
6,1,0,5,Rocky Mountain,,Colorado Mines,1913,N,N
5,2,0,3,Rocky Mountain,,Colorado State,1913,N,N
10,5,0,5,FBS Independents,,Cornell,1913,N,N
8,1,0,7,FBS Independents,,Dartmouth,1913,N,N
7,5,0,2,FBS Independents,,Davidson,1913,N,N
7,5,0,2,Rocky Mountain,,Denver,1913,N,N
8,4,0,4,Missouri Valley,,Drake,1913,N,N
7,3,0,4,FBS Independents,,Florida,1913,N,N
8,4,0,4,FBS Independents,,Georgetown,1913,N,N
8,2,0,6,FBS Independents,,Georgia,1913,N,N
9,2,0,7,FBS Independents,,Georgia Tech,1913,N,N
9,0,0,9,FBS Independents,,Harvard,1913,Y,N
7,3,0,4,Western,,Illinois,1913,N,N
7,4,0,3,Western,,Indiana,1913,N,N
7,2,0,5,Western,,Iowa,1913,N,N
8,4,0,4,Missouri Valley,,Iowa State,1913,N,N
8,3,0,5,Missouri Valley,,Kansas,1913,N,N
8,4,0,4,Missouri Valley,,Kansas State,1913,N,N
10,6,0,4,FBS Independents,,Lafayette,1913,N,N
8,3,0,5,FBS Independents,,Lehigh,1913,N,N
9,2,0,7,FBS Independents,,LSU,1913,N,N
8,5,0,3,FBS Independents,,Mercer,1913,N,N
7,1,0,6,FBS Independents,,Michigan,1913,N,N
7,2,0,5,Western,,Minnesota,1913,N,N
8,2,0,6,FBS Independents,,Mississippi State,1913,N,N
8,1,0,7,Missouri Valley,,Missouri,1913,N,N
9,2,0,7,FBS Independents,,Navy,1913,N,N
7,1,0,6,FBS Independents,,NC State,1913,N,N
8,0,0,8,Missouri Valley,,Nebraska,1913,N,N
9,4,0,5,FBS Independents,,North Carolina,1913,N,N
7,6,0,1,Western,,Northwestern,1913,N,N
7,0,0,7,FBS Independents,,Notre Dame,1913,N,N
7,3,0,4,Western,,Ohio State,1913,N,N
8,2,0,6,FBS Independents,,Oklahoma,1913,N,N
10,3,0,7,FBS Independents,,Ole Miss,1913,N,N
8,6,0,2,FBS Independents,,Penn State,1913,N,N
9,2,0,7,FBS Independents,,Pittsburgh,1913,N,N
8,2,0,6,FBS Independents,,Princeton,1913,N,N
7,2,0,5,Western,,Purdue,1913,N,N
7,3,0,4,FBS Independents,,Sewanee Univ. of the South,1913,N,N
7,3,0,4,FBS Independents,,South Carolina,1913,N,N
6,5,0,1,FBS Independents,,Southwestern University,1913,N,N
10,4,0,6,FBS Independents,,Syracuse,1913,N,N
9,3,0,6,FBS Independents,,Tennessee,1913,N,N
8,1,0,7,FBS Independents,,Texas,1913,N,N
9,5,0,4,FBS Independents,,Texas A&M,1913,N,N
9,5,0,4,FBS Independents,,The Citadel,1913,N,N
8,5,0,3,FBS Independents,,Tulane,1913,N,N
7,4,0,3,Rocky Mountain,,Utah,1913,N,N
8,3,0,5,FBS Independents,,Vanderbilt,1913,N,N
8,1,0,7,FBS Independents,,Virginia,1913,N,N
9,1,0,8,FBS Independents,,Virginia Tech,1913,N,N
10,3,0,7,FBS Independents,,VMI,1913,N,N
8,8,0,0,FBS Independents,,Wake Forest,1913,N,N
11,0,0,11,FBS Independents,,Washington & Jefferson,1913,N,N
9,1,0,8,FBS Independents,,Washington & Lee,1913,N,N
6,5,0,1,Missouri Valley,,Washington (MO),1913,N,N
9,6,0,3,FBS Independents,,West Virginia,1913,N,N
7,3,0,4,Western,,Wisconsin,1913,N,N
8,3,0,5,FBS Independents,,WV Wesleyan,1913,N,N
5,5,0,0,Rocky Mountain,,Wyoming,1913,N,N
10,5,0,5,FBS Independents,,Yale,1913,N,N
9,4,0,5,FBS Independents,,Alabama,1914,N,N
9,6,0,3,FBS Independents,,Arkansas,1914,N,N
9,0,0,9,FBS Independents,,Army,1914,Y,N
9,0,0,9,FBS Independents,,Auburn,1914,N,N
10,7,0,3,FBS Independents,,Baylor,1914,N,N
9,3,0,6,FBS Independents,,Brown,1914,N,N
9,4,0,5,FBS Independents,,Bucknell,1914,N,N
16,10,0,6,FBS Independents,,Carlisle,1914,N,N
7,2,0,5,Western,,Chicago,1914,N,N
9,3,0,6,FBS Independents,,Clemson,1914,N,N
8,2,0,6,FBS Independents,,Colgate,1914,N,N
6,1,0,5,Rocky Mountain,,Colorado,1914,N,N
6,2,0,4,Rocky Mountain,,Colorado College,1914,N,N
6,0,0,6,Rocky Mountain,,Colorado Mines,1914,N,N
7,4,0,3,Rocky Mountain,,Colorado State,1914,N,N
10,2,0,8,FBS Independents,,Cornell,1914,N,N
9,1,0,8,FBS Independents,,Dartmouth,1914,N,N
7,2,0,5,FBS Independents,,Davidson,1914,N,N
9,4,0,5,Rocky Mountain,,Denver,1914,N,N
8,3,0,5,Missouri Valley,,Drake,1914,N,N
7,2,0,5,FBS Independents,,Florida,1914,N,N
8,4,0,4,FBS Independents,,Georgetown,1914,N,N
9,6,0,3,FBS Independents,,Georgia,1914,N,N
8,2,0,6,FBS Independents,,Georgia Tech,1914,N,N
9,2,0,7,FBS Independents,,Harvard,1914,N,N
9,4,0,5,FBS Independents,,Haskell,1914,N,N
7,0,0,7,Western,,Illinois,1914,N,N
7,4,0,3,Western,,Indiana,1914,N,N
7,3,0,4,Western,,Iowa,1914,N,N
7,3,0,4,Missouri Valley,,Iowa State,1914,N,N
8,3,0,5,Missouri Valley,,Kansas,1914,N,N
7,6,0,1,Missouri Valley,,Kansas State,1914,N,N
10,4,0,6,FBS Independents,,Lafayette,1914,N,N
9,1,0,8,FBS Independents,,Lehigh,1914,N,N
9,4,0,5,FBS Independents,,LSU,1914,N,N
9,3,0,6,FBS Independents,,Michigan,1914,N,N
7,1,0,6,Western,,Minnesota,1914,N,N
8,2,0,6,FBS Independents,,Mississippi State,1914,N,N
8,3,0,5,Missouri Valley,,Missouri,1914,N,N
9,3,0,6,FBS Independents,,Navy,1914,N,N
6,4,0,2,FBS Independents,,NC State,1914,N,N
8,1,0,7,Missouri Valley,,Nebraska,1914,N,N
9,3,0,6,FBS Independents,,Newberry,1914,N,N
11,1,0,10,FBS Independents,,North Carolina,1914,N,N
7,6,0,1,Western,,Northwestern,1914,N,N
8,2,0,6,FBS Independents,,Notre Dame,1914,N,N
7,2,0,5,Western,,Ohio State,1914,N,N
11,1,0,10,FBS Independents,,Oklahoma,1914,N,N
9,2,0,7,FBS Independents,,Oklahoma State,1914,N,N
10,5,0,5,FBS Independents,,Ole Miss,1914,N,N
9,3,0,6,FBS Independents,,Penn State,1914,N,N
9,1,0,8,FBS Independents,,Pittsburgh,1914,N,N
8,3,0,5,FBS Independents,,Princeton,1914,N,N
7,2,0,5,Western,,Purdue,1914,N,N
8,4,0,4,FBS Independents,,Rice,1914,N,N
9,3,0,6,FBS Independents,,Rutgers,1914,N,N
8,3,0,5,FBS Independents,,Sewanee Univ. of the South,1914,N,N
11,6,0,5,FBS Independents,,South Carolina,1914,N,N
6,3,0,3,FBS Independents,,Southwestern University,1914,N,N
10,5,0,5,FBS Independents,,Syracuse,1914,N,N
10,5,0,5,FBS Independents,,TCU,1914,N,N
9,0,0,9,FBS Independents,,Tennessee,1914,N,N
8,0,0,8,FBS Independents,,Texas,1914,N,N
8,2,0,6,FBS Independents,,Texas A&M,1914,N,N
7,5,0,2,FBS Independents,,The Citadel,1914,N,N
7,4,0,3,FBS Independents,,Tulane,1914,N,N
6,3,0,3,Rocky Mountain,,Utah,1914,N,N
7,5,0,2,Rocky Mountain,,Utah State,1914,N,N
8,6,0,2,FBS Independents,,Vanderbilt,1914,N,N
9,1,0,8,FBS Independents,,Virginia,1914,N,N
9,3,0,6,FBS Independents,,Virginia Tech,1914,N,N
8,4,0,4,FBS Independents,,VMI,1914,N,N
9,6,0,3,FBS Independents,,Wake Forest,1914,N,N
11,1,0,10,FBS Independents,,Washington & Jefferson,1914,N,N
9,0,0,9,FBS Independents,,Washington & Lee,1914,N,N
7,4,0,3,Missouri Valley,,Washington (MO),1914,N,N
9,4,0,5,FBS Independents,,West Virginia,1914,N,N
7,3,0,4,Western,,Wisconsin,1914,N,N
9,8,0,1,FBS Independents,,Wofford,1914,N,N
7,3,0,4,FBS Independents,,WV Wesleyan,1914,N,N
6,5,0,1,Rocky Mountain,,Wyoming,1914,N,N
9,2,0,7,FBS Independents,,Yale,1914,N,N
8,2,0,6,FBS Independents,,Alabama,1915,N,N
7,2,0,5,Southwest,,Arkansas,1915,N,N
9,4,0,5,FBS Independents,,Army,1915,N,N
8,2,0,6,FBS Independents,,Auburn,1915,N,N
8,1,0,7,Southwest,,Baylor,1915,N,N
10,5,0,5,FBS Independents,,Brown,1915,N,N
11,7,0,4,FBS Independents,,Bucknell,1915,N,N
11,8,0,3,FBS Independents,,Carlisle,1915,N,N
7,2,0,5,Western,,Chicago,1915,N,N
8,5,0,3,FBS Independents,,Clemson,1915,N,N
6,1,0,5,FBS Independents,,Colgate,1915,N,N
7,6,0,1,Rocky Mountain,,Colorado,1915,N,N
8,2,0,6,Rocky Mountain,,Colorado College,1915,N,N
6,2,0,4,Rocky Mountain,,Colorado Mines,1915,N,N
7,0,0,7,Rocky Mountain,,Colorado State,1915,N,N
9,0,0,9,FBS Independents,,Cornell,1915,Y,N
9,1,0,8,FBS Independents,,Dartmouth,1915,N,N
8,3,0,5,FBS Independents,,Davidson,1915,N,N
7,3,0,4,Rocky Mountain,,Denver,1915,N,N
8,6,0,2,Missouri Valley,,Drake,1915,N,N
7,3,0,4,FBS Independents,,Florida,1915,N,N
8,3,0,5,FBS Independents,,Furman,1915,N,N
9,2,0,7,FBS Independents,,Georgetown,1915,N,N
9,2,0,7,FBS Independents,,Georgia,1915,N,N
8,1,0,7,FBS Independents,,Georgia Tech,1915,N,N
9,1,0,8,FBS Independents,,Harvard,1915,N,N
10,5,0,5,FBS Independents,,Haskell,1915,N,N
7,1,0,6,Western,,Illinois,1915,N,N
7,4,0,3,Western,,Indiana,1915,N,N
7,4,0,3,Western,,Iowa,1915,N,N
8,2,0,6,Missouri Valley,,Iowa State,1915,N,N
8,2,0,6,Missouri Valley,,Kansas,1915,N,N
8,4,0,4,Missouri Valley,,Kansas State,1915,N,N
8,2,0,6,FBS Independents,,Kentucky,1915,N,N
11,3,0,8,FBS Independents,,Lafayette,1915,N,N
10,4,0,6,FBS Independents,,Lehigh,1915,N,N
8,2,0,6,FBS Independents,,LSU,1915,N,N
8,3,0,5,FBS Independents,,Michigan,1915,N,N
7,0,0,7,Western,,Minnesota,1915,N,N
9,4,0,5,FBS Independents,,Mississippi College,1915,N,N
8,3,0,5,FBS Independents,,Mississippi State,1915,N,N
8,6,0,2,Missouri Valley,,Missouri,1915,N,N
9,6,0,3,FBS Independents,,Navy,1915,N,N
7,4,0,3,FBS Independents,,NC State,1915,N,N
8,0,0,8,Missouri Valley,,Nebraska,1915,N,N
7,5,0,2,FBS Independents,,Newberry,1915,N,N
8,4,0,4,FBS Independents,,North Carolina,1915,N,N
7,5,0,2,Western,,Northwestern,1915,N,N
8,1,0,7,FBS Independents,,Notre Dame,1915,N,N
7,2,0,5,Western,,Ohio State,1915,N,N
10,0,0,10,Southwest,,Oklahoma,1915,N,N
10,6,0,4,Southwest,,Oklahoma State,1915,N,N
8,6,0,2,FBS Independents,,Ole Miss,1915,N,N
9,2,0,7,FBS Independents,,Penn State,1915,N,N
8,0,0,8,FBS Independents,,Pittsburgh,1915,N,N
8,4,0,4,FBS Independents,,Presbyterian College,1915,N,N
8,2,0,6,FBS Independents,,Princeton,1915,N,N
7,4,0,3,Western,,Purdue,1915,N,N
8,3,0,5,Southwest,,Rice,1915,N,N
9,3,0,6,FBS Independents,,Sewanee Univ. of the South,1915,N,N
9,4,0,5,FBS Independents,,South Carolina,1915,N,N
6,3,0,3,Southwest,,Southwestern University,1915,N,N
12,2,0,10,FBS Independents,,Syracuse,1915,N,N
9,5,0,4,FBS Independents,,TCU,1915,N,N
8,4,0,4,FBS Independents,,Tennessee,1915,N,N
9,3,0,6,Southwest,,Texas,1915,N,N
8,2,0,6,Southwest,,Texas A&M,1915,N,N
8,3,0,5,FBS Independents,,The Citadel,1915,N,N
8,4,0,4,FBS Independents,,Tulane,1915,N,N
7,2,0,5,Rocky Mountain,,Utah,1915,N,N
7,4,0,3,Rocky Mountain,,Utah State,1915,N,N
10,1,0,9,FBS Independents,,Vanderbilt,1915,N,N
9,1,0,8,FBS Independents,,Virginia,1915,N,N
8,4,0,4,FBS Independents,,Virginia Tech,1915,N,N
9,2,0,7,FBS Independents,,VMI,1915,N,N
7,4,0,3,FBS Independents,,Wake Forest,1915,N,N
10,1,0,9,FBS Independents,,Washington & Jefferson,1915,N,N
8,1,0,7,FBS Independents,,Washington & Lee,1915,N,N
5,2,0,3,Missouri Valley,,Washington (MO),1915,N,N
7,2,0,5,FBS Independents,,West Virginia,1915,N,N
7,3,0,4,Western,,Wisconsin,1915,N,N
8,5,0,3,FBS Independents,,Wofford,1915,N,N
9,4,0,5,FBS Independents,,WV Wesleyan,1915,N,N
8,6,0,2,Rocky Mountain,,Wyoming,1915,N,N
9,5,0,4,FBS Independents,,Yale,1915,N,N
9,3,0,6,FBS Independents,,Alabama,1916,N,N
8,4,0,4,Southwest,,Arkansas,1916,N,N
9,0,0,9,FBS Independents,,Army,1916,N,N
8,2,0,6,FBS Independents,,Auburn,1916,N,N
10,1,0,9,Southwest,,Baylor,1916,N,N
9,1,0,8,FBS Independents,,Brown,1916,N,N
12,9,0,3,FBS Independents,,Bucknell,1916,N,N
11,5,0,6,Pacific,,California,1916,N,N
7,4,0,3,Western,,Chicago,1916,N,N
9,6,0,3,FBS Independents,,Clemson,1916,N,N
9,1,0,8,FBS Independents,,Colgate,1916,N,N
7,6,0,1,Rocky Mountain,,Colorado,1916,N,N
7,1,0,6,Rocky Mountain,,Colorado College,1916,N,N
6,3,0,3,Rocky Mountain,,Colorado Mines,1916,N,N
7,0,0,7,Rocky Mountain,,Colorado State,1916,N,N
8,2,0,6,FBS Independents,,Cornell,1916,N,N
9,3,0,6,FBS Independents,,Dartmouth,1916,N,N
9,4,0,5,FBS Independents,,Davidson,1916,N,N
7,3,0,4,Rocky Mountain,,Denver,1916,N,N
8,5,0,3,Missouri Valley,,Drake,1916,N,N
5,5,0,0,FBS Independents,,Florida,1916,N,N
9,5,0,4,FBS Independents,,Furman,1916,N,N
9,1,0,8,FBS Independents,,Georgetown,1916,N,N
9,3,0,6,FBS Independents,,Georgia,1916,N,N
9,1,0,8,FBS Independents,,Georgia Tech,1916,N,N
10,3,0,7,FBS Independents,,Harvard,1916,N,N
9,6,0,3,FBS Independents,,Haskell,1916,N,N
7,3,0,4,Western,,Illinois,1916,N,N
7,4,0,3,Western,,Indiana,1916,N,N
7,3,0,4,Western,,Iowa,1916,N,N
8,2,0,6,Missouri Valley,,Iowa State,1916,N,N
8,4,0,4,Missouri Valley,,Kansas,1916,N,N
8,1,0,7,Missouri Valley,,Kansas State,1916,N,N
7,2,0,5,FBS Independents,,Kentucky,1916,N,N
9,7,0,2,FBS Independents,,Lafayette,1916,N,N
9,2,0,7,FBS Independents,,Lehigh,1916,N,N
10,2,0,8,FBS Independents,,LSU,1916,N,N
9,2,0,7,FBS Independents,,Michigan,1916,N,N
7,1,0,6,Western,,Minnesota,1916,N,N
7,3,0,4,FBS Independents,,Mississippi College,1916,N,N
9,4,0,5,FBS Independents,,Mississippi State,1916,N,N
8,2,0,6,Missouri Valley,,Missouri,1916,N,N
10,4,0,6,FBS Independents,,Navy,1916,N,N
7,5,0,2,FBS Independents,,NC State,1916,N,N
8,2,0,6,Missouri Valley,,Nebraska,1916,N,N
7,2,0,5,FBS Independents,,Newberry,1916,N,N
9,4,0,5,FBS Independents,,North Carolina,1916,N,N
7,1,0,6,Western,,Northwestern,1916,N,N
9,1,0,8,FBS Independents,,Notre Dame,1916,N,N
7,0,0,7,Western,,Ohio State,1916,N,N
11,5,0,6,Southwest,,Oklahoma,1916,N,N
8,4,0,4,Southwest,,Oklahoma State,1916,N,N
9,6,0,3,FBS Independents,,Ole Miss,1916,N,N
8,1,0,7,Pacific,,Oregon,1916,N,N
9,5,0,4,Pacific,,Oregon State,1916,N,N
10,2,0,8,FBS Independents,,Penn State,1916,N,N
8,0,0,8,FBS Independents,,Pittsburgh,1916,Y,N
7,3,0,4,FBS Independents,,Presbyterian College,1916,N,N
8,2,0,6,FBS Independents,,Princeton,1916,N,N
7,5,0,2,Western,,Purdue,1916,N,N
9,1,0,8,Southwest,,Rice,1916,N,N
7,4,0,3,FBS Independents,,Rutgers,1916,N,N
9,2,0,7,FBS Independents,,Sewanee Univ. of the South,1916,N,N
10,9,0,1,FBS Independents,,SMU,1916,N,N
9,7,0,2,FBS Independents,,South Carolina,1916,N,N
7,6,0,1,Southwest,,Southwestern University,1916,N,N
9,4,0,5,FBS Independents,,Syracuse,1916,N,N
9,3,0,6,FBS Independents,,TCU,1916,N,N
9,1,0,8,FBS Independents,,Tennessee,1916,N,N
9,2,0,7,Southwest,,Texas,1916,N,N
9,3,0,6,Southwest,,Texas A&M,1916,N,N
8,1,0,7,FBS Independents,,The Citadel,1916,N,N
8,4,0,4,FBS Independents,,Tulane,1916,N,N
5,2,0,3,Rocky Mountain,,Utah,1916,N,N
7,6,0,1,Rocky Mountain,,Utah State,1916,N,N
9,2,0,7,FBS Independents,,Vanderbilt,1916,N,N
9,5,0,4,FBS Independents,,Virginia,1916,N,N
9,2,0,7,FBS Independents,,Virginia Tech,1916,N,N
9,5,0,4,FBS Independents,,VMI,1916,N,N
6,3,0,3,FBS Independents,,Wake Forest,1916,N,N
7,0,0,7,Pacific,,Washington,1916,N,N
10,2,0,8,FBS Independents,,Washington & Jefferson,1916,N,N
9,2,0,7,FBS Independents,,Washington & Lee,1916,N,N
7,4,0,3,Missouri Valley,,Washington (MO),1916,N,N
9,2,0,7,FBS Independents,,West Virginia,1916,N,N
7,3,0,4,Western,,Wisconsin,1916,N,N
9,7,0,2,FBS Independents,,Wofford,1916,N,N
9,6,0,3,FBS Independents,,WV Wesleyan,1916,N,N
5,4,0,1,Rocky Mountain,,Wyoming,1916,N,N
9,1,0,8,FBS Independents,,Yale,1916,N,N
8,3,0,5,FBS Independents,,Alabama,1917,N,N
7,2,0,5,Southwest,,Arkansas,1917,N,N
8,1,0,7,FBS Independents,,Army,1917,N,N
9,3,0,6,FBS Independents,,Auburn,1917,N,N
9,2,0,7,Southwest,,Baylor,1917,N,N
10,2,0,8,FBS Independents,,Brown,1917,N,N
9,6,0,3,FBS Independents,,Bucknell,1917,N,N
11,5,0,6,Pacific,,California,1917,N,N
9,6,0,3,FBS Independents,,Carlisle,1917,N,N
6,3,0,3,Western,,Chicago,1917,N,N
8,2,0,6,FBS Independents,,Clemson,1917,N,N
6,2,0,4,FBS Independents,,Colgate,1917,N,N
8,2,0,6,Rocky Mountain,,Colorado,1917,N,N
6,3,0,3,Rocky Mountain,,Colorado College,1917,N,N
8,3,0,5,Rocky Mountain,,Colorado Mines,1917,N,N
8,8,0,0,Rocky Mountain,,Colorado State,1917,N,N
9,6,0,3,FBS Independents,,Cornell,1917,N,N
8,3,0,5,FBS Independents,,Dartmouth,1917,N,N
10,4,0,6,FBS Independents,,Davidson,1917,N,N
9,0,0,9,Rocky Mountain,,Denver,1917,N,N
7,6,0,1,Missouri Valley,,Drake,1917,N,N
6,4,0,2,FBS Independents,,Florida,1917,N,N
8,5,0,3,FBS Independents,,Furman,1917,N,N
8,1,0,7,FBS Independents,,Georgetown,1917,N,N
9,0,0,9,FBS Independents,,Georgia Tech,1917,Y,N
5,3,0,2,FBS Independents,,Idaho,1917,N,N
8,2,0,6,Western,,Illinois,1917,N,N
7,2,0,5,Western,,Indiana,1917,N,N
8,5,0,3,Western,,Iowa,1917,N,N
7,2,0,5,Missouri Valley,,Iowa State,1917,N,N
8,2,0,6,Missouri Valley,,Kansas,1917,N,N
8,2,0,6,Missouri Valley,,Kansas State,1917,N,N
9,6,0,3,FBS Independents,,Kentucky,1917,N,N
8,5,0,3,FBS Independents,,Lafayette,1917,N,N
9,2,0,7,FBS Independents,,Lehigh,1917,N,N
8,5,0,3,FBS Independents,,LSU,1917,N,N
8,0,0,8,FBS Independents,,Mare Island Marines,1917,N,N
8,3,0,5,FBS Independents,,Maryland,1917,N,N
10,2,0,8,Western,,Michigan,1917,N,N
5,1,0,4,Western,,Minnesota,1917,N,N
7,1,0,6,FBS Independents,,Mississippi State,1917,N,N
8,5,0,3,Missouri Valley,,Missouri,1917,N,N
5,4,0,1,FBS Independents,,Montana,1917,N,N
8,1,0,7,FBS Independents,,Navy,1917,N,N
9,3,0,6,FBS Independents,,NC State,1917,N,N
7,2,0,5,Missouri Valley,,Nebraska,1917,N,N
6,6,0,0,FBS Independents,,Newberry,1917,N,N
7,2,0,5,Western,,Northwestern,1917,N,N
8,1,0,7,FBS Independents,,Notre Dame,1917,N,N
9,0,0,9,Western,,Ohio State,1917,N,N
11,4,0,7,Southwest,,Oklahoma,1917,N,N
9,5,0,4,Southwest,,Oklahoma State,1917,N,N
6,5,0,1,FBS Independents,,Ole Miss,1917,N,N
7,3,0,4,Pacific,,Oregon,1917,N,N
7,2,0,5,Pacific,,Oregon State,1917,N,N
9,4,0,5,FBS Independents,,Penn State,1917,N,N
10,0,0,10,FBS Independents,,Pittsburgh,1917,N,N
9,1,0,8,FBS Independents,,Presbyterian College,1917,N,N
7,4,0,3,Western,,Purdue,1917,N,N
8,1,0,7,Southwest,,Rice,1917,N,N
9,2,0,7,FBS Independents,,Rutgers,1917,N,N
8,3,0,5,FBS Independents,,Sewanee Univ. of the South,1917,N,N
8,5,0,3,FBS Independents,,SMU,1917,N,N
8,5,0,3,FBS Independents,,South Carolina,1917,N,N
7,5,0,2,FBS Independents,,Southwestern University,1917,N,N
10,2,0,8,FBS Independents,,Syracuse,1917,N,N
10,2,0,8,FBS Independents,,TCU,1917,N,N
8,4,0,4,Southwest,,Texas,1917,N,N
8,0,0,8,Southwest,,Texas A&M,1917,N,N
6,3,0,3,FBS Independents,,The Citadel,1917,N,N
8,3,0,5,FBS Independents,,Tulane,1917,N,N
9,9,0,0,FBS Independents,,Tulsa,1917,N,N
6,4,0,2,Rocky Mountain,,Utah,1917,N,N
8,0,0,8,Rocky Mountain,,Utah State,1917,N,N
8,3,0,5,FBS Independents,,Vanderbilt,1917,N,N
9,2,0,7,FBS Independents,,Virginia Tech,1917,N,N
9,5,0,4,FBS Independents,,VMI,1917,N,N
8,7,0,1,FBS Independents,,Wake Forest,1917,N,N
4,3,0,1,Pacific,,Washington,1917,N,N
10,3,0,7,FBS Independents,,Washington & Jefferson,1917,N,N
7,3,0,4,FBS Independents,,Washington & Lee,1917,N,N
7,3,0,4,Missouri Valley,,Washington (MO),1917,N,N
7,0,0,7,Pacific,,Washington State,1917,N,N
10,3,0,7,FBS Independents,,West Virginia,1917,N,N
7,3,0,4,Western,,Wisconsin,1917,N,N
9,4,0,5,FBS Independents,,Wofford,1917,N,N
7,4,0,3,Rocky Mountain,,Wyoming,1917,N,N
5,2,0,3,Southwest,,Arkansas,1918,N,N
7,5,0,2,FBS Independents,,Auburn,1918,N,N
6,6,0,0,Southwest,,Baylor,1918,N,N
5,3,0,2,FBS Independents,,Brown,1918,N,N
8,2,0,6,Pacific,,California,1918,N,N
11,7,0,4,Western,,Chicago,1918,N,N
7,2,0,5,FBS Independents,,Clemson,1918,N,N
5,3,0,2,Rocky Mountain,,Colorado,1918,N,N
3,2,0,1,Rocky Mountain,,Colorado College,1918,N,N
4,0,0,4,Rocky Mountain,,Colorado Mines,1918,N,N
2,2,0,0,Rocky Mountain,,Colorado State,1918,N,N
6,3,0,3,FBS Independents,,Dartmouth,1918,N,N
4,2,0,2,FBS Independents,,Davidson,1918,N,N
5,2,0,3,Rocky Mountain,,Denver,1918,N,N
5,2,0,3,Missouri Valley,,Drake,1918,N,N
9,6,0,3,FBS Independents,,Furman,1918,N,N
7,1,0,6,FBS Independents,,Georgia Tech,1918,N,N
8,1,0,7,FBS Independents,,Great Lakes Navy,1918,N,N
3,1,0,2,FBS Independents,,Harvard,1918,N,N
7,2,0,5,Western,,Illinois,1918,N,N
4,2,0,2,Western,,Indiana,1918,N,N
9,2,0,7,Western,,Iowa,1918,N,N
3,3,0,0,Missouri Valley,,Iowa State,1918,N,N
4,2,0,2,Missouri Valley,,Kansas,1918,N,N
5,1,0,4,Missouri Valley,,Kansas State,1918,N,N
3,1,0,2,FBS Independents,,Kentucky,1918,N,N
7,4,0,3,FBS Independents,,Lafayette,1918,N,N
6,3,0,3,FBS Independents,,Lehigh,1918,N,N
11,1,0,10,FBS Independents,,Mare Island Marines,1918,N,N
6,1,0,5,FBS Independents,,Maryland,1918,N,N
5,0,0,5,Western,,Michigan,1918,Y,N
7,3,0,4,FBS Independents,,Michigan State,1918,N,N
8,3,0,5,Western,,Minnesota,1918,N,N
5,2,0,3,FBS Independents,,Mississippi State,1918,N,N
5,1,0,4,FBS Independents,,Navy,1918,N,N
4,3,0,1,FBS Independents,,NC State,1918,N,N
6,4,0,2,Missouri Valley,,Nebraska,1918,N,N
5,2,0,3,Western,,Northwestern,1918,N,N
6,2,0,4,FBS Independents,,Notre Dame,1918,N,N
6,3,0,3,Western,,Ohio State,1918,N,N
6,0,0,6,Southwest,,Oklahoma,1918,N,N
6,2,0,4,Southwest,,Oklahoma State,1918,N,N
4,3,0,1,FBS Independents,,Ole Miss,1918,N,N
6,2,0,4,Pacific,,Oregon,1918,N,N
6,4,0,2,Pacific,,Oregon State,1918,N,N
4,3,0,1,FBS Independents,,Penn State,1918,N,N
5,1,0,4,FBS Independents,,Pittsburgh,1918,Y,N
2,0,0,2,FBS Independents,,Presbyterian College,1918,N,N
6,3,0,3,Western,,Purdue,1918,N,N
7,6,0,1,Southwest,,Rice,1918,N,N
7,2,0,5,FBS Independents,,Rutgers,1918,N,N
4,2,0,2,FBS Independents,,Sewanee Univ. of the South,1918,N,N
5,2,0,3,Southwest,,SMU,1918,N,N
4,1,0,3,FBS Independents,,South Carolina,1918,N,N
5,2,0,3,FBS Independents,,Southwestern University,1918,N,N
4,4,0,0,Pacific,,Stanford,1918,N,N
6,1,0,5,FBS Independents,,Syracuse,1918,N,N
6,2,0,4,FBS Independents,,TCU,1918,N,N
9,0,0,9,Southwest,,Texas,1918,N,N
7,1,0,6,Southwest,,Texas A&M,1918,N,N
3,3,0,0,FBS Independents,,The Citadel,1918,N,N
6,2,0,4,FBS Independents,,Vanderbilt,1918,N,N
7,0,0,7,FBS Independents,,Virginia Tech,1918,N,N
4,3,0,1,FBS Independents,,VMI,1918,N,N
3,2,0,1,FBS Independents,,Wake Forest,1918,N,N
2,1,0,1,Pacific,,Washington,1918,N,N
4,2,0,2,FBS Independents,,Washington & Jefferson,1918,N,N
3,2,0,1,FBS Independents,,Washington & Lee,1918,N,N
6,0,0,6,Missouri Valley,,Washington (MO),1918,N,N
6,3,0,3,Western,,Wisconsin,1918,N,N
3,3,0,0,FBS Independents,,Wofford,1918,N,N
9,1,0,8,FBS Independents,,Alabama,1919,N,N
7,4,0,3,Southwest,,Arkansas,1919,N,N
9,3,0,6,FBS Independents,,Army,1919,N,N
9,1,0,8,FBS Independents,,Auburn,1919,N,N
9,4,0,5,Southwest,,Baylor,1919,N,N
8,3,0,5,FBS Independents,,Boston College,1919,N,N
10,4,0,6,FBS Independents,,Brown,1919,N,N
10,4,0,6,FBS Independents,,Bucknell,1919,N,N
9,3,0,6,Pacific,,California,1919,N,N
9,0,0,9,FBS Independents,,Centre,1919,N,N
7,2,0,5,Western,,Chicago,1919,N,N
10,2,0,8,FBS Independents,,Clemson,1919,N,N
7,1,0,6,FBS Independents,,Colgate,1919,N,N
6,4,0,2,Rocky Mountain,,Colorado,1919,N,N
7,2,0,5,Rocky Mountain,,Colorado College,1919,N,N
6,4,0,2,Rocky Mountain,,Colorado Mines,1919,N,N
8,1,0,7,Rocky Mountain,,Colorado State,1919,N,N
8,5,0,3,FBS Independents,,Cornell,1919,N,N
8,2,0,6,FBS Independents,,Dartmouth,1919,N,N
11,7,0,4,FBS Independents,,Davidson,1919,N,N
7,6,0,1,Rocky Mountain,,Denver,1919,N,N
7,3,0,4,Missouri Valley,,Drake,1919,N,N
7,5,0,2,FBS Independents,,Erskine,1919,N,N
8,3,0,5,FBS Independents,,Florida,1919,N,N
9,3,0,6,FBS Independents,,Furman,1919,N,N
10,3,0,7,FBS Independents,,Georgetown,1919,N,N
9,5,0,4,FBS Independents,,Georgia,1919,N,N
10,3,0,7,FBS Independents,,Georgia Tech,1919,N,N
6,5,0,1,Missouri Valley,,Grinnell,1919,N,N
10,0,0,10,FBS Independents,,Harvard,1919,N,N
7,1,0,6,Western,,Illinois,1919,Y,N
7,4,0,3,Western,,Indiana,1919,N,N
7,2,0,5,Western,,Iowa,1919,N,N
8,3,0,5,Missouri Valley,,Iowa State,1919,N,N
8,3,0,5,Missouri Valley,,Kansas,1919,N,N
10,6,0,4,Missouri Valley,,Kansas State,1919,N,N
8,5,0,3,FBS Independents,,Kentucky,1919,N,N
8,2,0,6,FBS Independents,,Lafayette,1919,N,N
9,3,0,6,FBS Independents,,Lehigh,1919,N,N
8,2,0,6,FBS Independents,,LSU,1919,N,N
9,4,0,5,FBS Independents,,Maryland,1919,N,N
7,4,0,3,Western,,Michigan,1919,N,N
7,3,0,4,Western,,Minnesota,1919,N,N
9,6,0,3,FBS Independents,,Mississippi College,1919,N,N
8,2,0,6,FBS Independents,,Mississippi State,1919,N,N
8,1,0,7,Missouri Valley,,Missouri,1919,N,N
8,1,0,7,FBS Independents,,Navy,1919,N,N
9,2,0,7,FBS Independents,,NC State,1919,N,N
8,4,0,4,FBS Independents,,Nebraska,1919,N,N
7,4,0,3,FBS Independents,,Newberry,1919,N,N
8,3,0,5,FBS Independents,,North Carolina,1919,N,N
7,5,0,2,Western,,Northwestern,1919,N,N
9,0,0,9,FBS Independents,,Notre Dame,1919,N,N
9,6,0,3,FBS Independents,,Oglethorpe,1919,N,N
7,1,0,6,Western,,Ohio State,1919,N,N
10,3,0,7,Southwest,,Oklahoma,1919,N,N
8,5,0,3,Southwest,,Oklahoma State,1919,N,N
8,4,0,4,FBS Independents,,Ole Miss,1919,N,N
7,2,0,5,Pacific,,Oregon,1919,N,N
9,5,0,4,Pacific,,Oregon State,1919,N,N
8,1,0,7,FBS Independents,,Penn State,1919,N,N
9,2,0,7,FBS Independents,,Pittsburgh,1919,N,N
9,4,0,5,FBS Independents,,Presbyterian College,1919,N,N
7,3,0,4,FBS Independents,,Princeton,1919,N,N
7,5,0,2,Western,,Purdue,1919,N,N
9,1,0,8,Southwest,,Rice,1919,N,N
8,3,0,5,FBS Independents,,Rutgers,1919,N,N
10,7,0,3,FBS Independents,,Samford,1919,N,N
9,6,0,3,FBS Independents,,Sewanee Univ. of the South,1919,N,N
10,4,0,6,Southwest,,SMU,1919,N,N
9,8,0,1,FBS Independents,,South Carolina,1919,N,N
8,5,0,3,FBS Independents,,Southwestern University,1919,N,N
7,3,0,4,FBS Independents,,Spring Hill,1919,N,N
7,3,0,4,Pacific,,Stanford,1919,N,N
11,3,0,8,FBS Independents,,Syracuse,1919,N,N
8,6,0,2,FBS Independents,,TCU,1919,N,N
9,4,0,5,FBS Independents,,Tennessee,1919,N,N
9,3,0,6,Southwest,,Texas,1919,N,N
10,0,0,10,Southwest,,Texas A&M,1919,N,N
9,5,0,4,FBS Independents,,The Citadel,1919,N,N
9,2,0,7,FBS Independents,,Tulane,1919,N,N
7,2,0,5,Rocky Mountain,,Utah,1919,N,N
7,2,0,5,Rocky Mountain,,Utah State,1919,N,N
8,2,0,6,FBS Independents,,Vanderbilt,1919,N,N
9,6,0,3,FBS Independents,,Virginia,1919,N,N
9,4,0,5,FBS Independents,,Virginia Tech,1919,N,N
8,2,0,6,FBS Independents,,VMI,1919,N,N
8,6,0,2,FBS Independents,,Wake Forest,1919,N,N
6,1,0,5,Pacific,,Washington,1919,N,N
8,2,0,6,FBS Independents,,Washington & Jefferson,1919,N,N
9,1,0,8,FBS Independents,,Washington & Lee,1919,N,N
7,2,0,5,Missouri Valley,,Washington (MO),1919,N,N
7,2,0,5,Pacific,,Washington State,1919,N,N
10,2,0,8,FBS Independents,,West Virginia,1919,N,N
7,2,0,5,Western,,Wisconsin,1919,N,N
6,3,0,3,FBS Independents,,Wofford,1919,N,N
8,5,0,3,Rocky Mountain,,Wyoming,1919,N,N
8,3,0,5,FBS Independents,,Yale,1919,N,N
11,1,0,10,FBS Independents,,Alabama,1920,N,N
7,3,0,4,Southwest,,Arkansas,1920,N,N
9,2,0,7,FBS Independents,,Auburn,1920,N,N
9,4,0,5,Southwest,,Baylor,1920,N,N
9,3,0,6,FBS Independents,,Birmingham-Southern,1920,N,N
9,3,0,6,FBS Independents,,Brown,1920,N,N
9,0,0,9,Pacific,,California,1920,Y,N
10,2,0,8,FBS Independents,,Centre,1920,N,N
8,5,0,3,FBS Independents,,Chattanooga,1920,N,N
7,4,0,3,Western,,Chicago,1920,N,N
11,7,0,4,FBS Independents,,Clemson,1920,N,N
8,7,0,1,FBS Independents,,Colgate,1920,N,N
7,3,0,4,Rocky Mountain,,Colorado,1920,N,N
7,1,0,6,Rocky Mountain,,Colorado College,1920,N,N
6,6,0,0,Rocky Mountain,,Colorado Mines,1920,N,N
8,1,0,7,Rocky Mountain,,Colorado State,1920,N,N
8,2,0,6,FBS Independents,,Cornell,1920,N,N
9,2,0,7,FBS Independents,,Dartmouth,1920,N,N
10,5,0,5,FBS Independents,,Davidson,1920,N,N
7,4,0,3,Rocky Mountain,,Denver,1920,N,N
10,5,0,5,Missouri Valley,,Drake,1920,N,N
8,3,0,5,FBS Independents,,Florida,1920,N,N
10,1,0,9,FBS Independents,,Furman,1920,N,N
9,0,0,9,FBS Independents,,Georgia,1920,N,N
9,1,0,8,FBS Independents,,Georgia Tech,1920,N,N
7,4,0,3,Missouri Valley,,Grinnell,1920,N,N
9,1,0,8,FBS Independents,,Harvard,1920,N,N
7,2,0,5,Western,,Illinois,1920,N,N
7,2,0,5,Western,,Indiana,1920,N,N
7,2,0,5,Western,,Iowa,1920,N,N
8,4,0,4,Missouri Valley,,Iowa State,1920,N,N
8,3,0,5,Missouri Valley,,Kansas,1920,N,N
9,6,0,3,Missouri Valley,,Kansas State,1920,N,N
8,5,0,3,FBS Independents,,Kentucky,1920,N,N
8,3,0,5,FBS Independents,,Lafayette,1920,N,N
9,3,0,6,FBS Independents,,Lehigh,1920,N,N
9,3,0,6,FBS Independents,,LSU,1920,N,N
9,2,0,7,FBS Independents,,Maryland,1920,N,N
9,7,0,2,FBS Independents,,Mercer,1920,N,N
7,2,0,5,Western,,Michigan,1920,N,N
7,6,0,1,Western,,Minnesota,1920,N,N
8,5,0,3,FBS Independents,,Mississippi College,1920,N,N
8,3,0,5,FBS Independents,,Mississippi State,1920,N,N
8,1,0,7,Missouri Valley,,Missouri,1920,N,N
8,2,0,6,FBS Independents,,Navy,1920,N,N
10,3,0,7,FBS Independents,,NC State,1920,N,N
9,3,0,6,FBS Independents,,Nebraska,1920,N,N
8,7,0,1,FBS Independents,,Newberry,1920,N,N
8,6,0,2,FBS Independents,,North Carolina,1920,N,N
7,4,0,3,Western,,Northwestern,1920,N,N
9,0,0,9,FBS Independents,,Notre Dame,1920,N,N
9,4,0,5,FBS Independents,,Oglethorpe,1920,N,N
8,1,0,7,Western,,Ohio State,1920,N,N
7,0,0,7,Missouri Valley,,Oklahoma,1920,N,N
8,8,0,0,Southwest,,Oklahoma State,1920,N,N
6,2,0,4,Pacific,,Oregon,1920,N,N
6,4,0,2,Pacific,,Oregon State,1920,N,N
9,0,0,9,FBS Independents,,Penn State,1920,N,N
10,5,0,5,Southwest,,Phillips,1920,N,N
8,1,0,7,FBS Independents,,Pittsburgh,1920,N,N
7,1,0,6,FBS Independents,,Presbyterian College,1920,N,N
7,0,0,7,FBS Independents,,Princeton,1920,N,N
7,5,0,2,Western,,Purdue,1920,N,N
8,3,0,5,Southwest,,Rice,1920,N,N
9,7,0,2,FBS Independents,,Rutgers,1920,N,N
9,6,0,3,FBS Independents,,Samford,1920,N,N
8,3,0,5,FBS Independents,,Sewanee Univ. of the South,1920,N,N
10,7,0,3,Southwest,,SMU,1920,N,N
9,4,0,5,FBS Independents,,South Carolina,1920,N,N
8,7,0,1,FBS Independents,,Southwestern University,1920,N,N
7,3,0,4,Pacific,,Stanford,1920,N,N
9,3,0,6,FBS Independents,,Syracuse,1920,N,N
10,1,0,9,FBS Independents,,TCU,1920,N,N
9,2,0,7,FBS Independents,,Tennessee,1920,N,N
9,0,0,9,Southwest,,Texas,1920,N,N
8,2,0,6,Southwest,,Texas A&M,1920,N,N
8,6,0,2,FBS Independents,,The Citadel,1920,N,N
9,3,0,6,FBS Independents,,Tulane,1920,N,N
7,6,0,1,Rocky Mountain,,Utah,1920,N,N
7,2,0,5,Rocky Mountain,,Utah State,1920,N,N
9,4,0,5,FBS Independents,,Vanderbilt,1920,N,N
9,3,0,6,FBS Independents,,Virginia,1920,N,N
10,6,0,4,FBS Independents,,Virginia Tech,1920,N,N
9,0,0,9,FBS Independents,,VMI,1920,N,N
9,7,0,2,FBS Independents,,Wake Forest,1920,N,N
6,5,0,1,Pacific,,Washington,1920,N,N
10,3,0,7,FBS Independents,,Washington & Jefferson,1920,N,N
8,3,0,5,FBS Independents,,Washington & Lee,1920,N,N
8,4,0,4,Missouri Valley,,Washington (MO),1920,N,N
6,1,0,5,Pacific,,Washington State,1920,N,N
10,5,0,5,FBS Independents,,West Virginia,1920,N,N
7,1,0,6,Western,,Wisconsin,1920,N,N
9,9,0,0,FBS Independents,,Wofford,1920,N,N
10,5,0,5,Rocky Mountain,,Wyoming,1920,N,N
8,3,0,5,FBS Independents,,Yale,1920,N,N
11,5,0,6,Southern,,Alabama,1921,N,N
9,4,0,5,Southwest,,Arkansas,1921,N,N
8,3,0,5,Southern,,Auburn,1921,N,N
11,3,0,8,Southwest,,Baylor,1921,N,N
9,5,0,4,FBS Independents,,Birmingham-Southern,1921,N,N
9,4,0,5,FBS Independents,,Brown,1921,N,N
10,1,0,9,Pacific,,California,1921,Y,N
11,1,0,10,FBS Independents,,Centre,1921,N,N
10,6,0,4,FBS Independents,,Chattanooga,1921,N,N
7,1,0,6,Western,,Chicago,1921,N,N
9,6,0,3,Southern,,Clemson,1921,N,N
10,6,0,4,FBS Independents,,Colgate,1921,N,N
6,1,0,5,Rocky Mountain,,Colorado,1921,N,N
8,4,0,4,Rocky Mountain,,Colorado College,1921,N,N
6,5,0,1,Rocky Mountain,,Colorado Mines,1921,N,N
6,4,0,2,Rocky Mountain,,Colorado State,1921,N,N
8,6,0,2,FBS Independents,,Columbia,1921,N,N
8,0,0,8,FBS Independents,,Cornell,1921,Y,N
9,3,0,6,FBS Independents,,Dartmouth,1921,N,N
10,6,0,4,FBS Independents,,Davidson,1921,N,N
7,3,0,4,Rocky Mountain,,Denver,1921,N,N
7,2,0,5,Missouri Valley,,Drake,1921,N,N
8,2,0,6,FBS Independents,,Erskine,1921,N,N
11,5,0,6,FBS Independents,,Florida,1921,N,N
10,3,0,7,FBS Independents,,Furman,1921,N,N
10,2,0,8,Southern,,Georgia,1921,N,N
9,1,0,8,Southern,,Georgia Tech,1921,N,N
7,5,0,2,Missouri Valley,,Grinnell,1921,N,N
10,3,0,7,FBS Independents,,Harvard,1921,N,N
8,4,0,4,FBS Independents,,Idaho,1921,N,N
7,4,0,3,Western,,Illinois,1921,N,N
7,4,0,3,Western,,Indiana,1921,N,N
7,0,0,7,Western,,Iowa,1921,N,N
8,4,0,4,Missouri Valley,,Iowa State,1921,N,N
7,3,0,4,Missouri Valley,,Kansas,1921,N,N
8,3,0,5,Missouri Valley,,Kansas State,1921,N,N
8,4,0,4,Southern,,Kentucky,1921,N,N
9,0,0,9,FBS Independents,,Lafayette,1921,N,N
8,4,0,4,FBS Independents,,Lehigh,1921,N,N
8,2,0,6,FBS Independents,,LSU,1921,N,N
9,6,0,3,Southern,,Maryland,1921,N,N
9,6,0,3,FBS Independents,,Mercer,1921,N,N
7,1,0,6,Western,,Michigan,1921,N,N
7,4,0,3,Western,,Minnesota,1921,N,N
10,2,0,8,FBS Independents,,Mississippi College,1921,N,N
9,4,0,5,Southern,,Mississippi State,1921,N,N
8,2,0,6,Missouri Valley,,Missouri,1921,N,N
7,1,0,6,FBS Independents,,Navy,1921,N,N
9,4,0,5,Southern,,NC State,1921,N,N
8,1,0,7,Missouri Valley,,Nebraska,1921,N,N
7,4,0,3,FBS Independents,,Newberry,1921,N,N
9,2,0,7,Southern,,North Carolina,1921,N,N
7,6,0,1,Western,,Northwestern,1921,N,N
11,1,0,10,FBS Independents,,Notre Dame,1921,N,N
9,4,0,5,FBS Independents,,Oglethorpe,1921,N,N
7,2,0,5,Western,,Ohio State,1921,N,N
8,3,0,5,Missouri Valley,,Oklahoma,1921,N,N
10,5,0,5,Southwest,,Oklahoma State,1921,N,N
9,6,0,3,FBS Independents,,Ole Miss,1921,N,N
9,2,0,7,Pacific,,Oregon,1921,N,N
9,4,0,5,Pacific,,Oregon State,1921,N,N
10,0,0,10,FBS Independents,,Penn State,1921,N,N
9,5,0,4,FBS Independents,,Phillips,1921,N,N
9,4,0,5,FBS Independents,,Pittsburgh,1921,N,N
8,7,0,1,FBS Independents,,Presbyterian College,1921,N,N
7,3,0,4,FBS Independents,,Princeton,1921,N,N
7,6,0,1,Western,,Purdue,1921,N,N
9,5,0,4,Southwest,,Rice,1921,N,N
8,4,0,4,FBS Independents,,Richmond,1921,N,N
9,5,0,4,FBS Independents,,Rutgers,1921,N,N
9,6,0,3,FBS Independents,,Samford,1921,N,N
8,2,0,6,FBS Independents,,Sewanee Univ. of the South,1921,N,N
8,7,0,1,Southwest,,SMU,1921,N,N
8,2,0,6,FBS Independents,,South Carolina,1921,N,N
7,6,0,1,FBS Independents,,Southwestern University,1921,N,N
8,4,0,4,FBS Independents,,Spring Hill,1921,N,N
8,3,0,5,Pacific,,Stanford,1921,N,N
9,2,0,7,FBS Independents,,Syracuse,1921,N,N
10,3,0,7,FBS Independents,,TCU,1921,N,N
9,2,0,7,Southern,,Tennessee,1921,N,N
8,1,0,7,Southwest,,Texas,1921,N,N
9,2,0,7,Southwest,,Texas A&M,1921,N,N
8,4,0,4,FBS Independents,,The Citadel,1921,N,N
10,6,0,4,FBS Independents,,Tulane,1921,N,N
6,3,0,3,Rocky Mountain,,Utah,1921,N,N
8,1,0,7,Rocky Mountain,,Utah State,1921,N,N
8,1,0,7,FBS Independents,,Vanderbilt,1921,N,N
9,4,0,5,Southern,,Virginia,1921,N,N
10,3,0,7,Southern,,Virginia Tech,1921,N,N
9,5,0,4,FBS Independents,,VMI,1921,N,N
10,8,0,2,FBS Independents,,Wake Forest,1921,N,N
8,5,0,3,Pacific,,Washington,1921,N,N
11,0,0,11,FBS Independents,,Washington & Jefferson,1921,N,N
9,3,0,6,Southern,,Washington & Lee,1921,N,N
8,3,0,5,Missouri Valley,,Washington (MO),1921,N,N
7,3,0,4,Pacific,,Washington State,1921,N,N
10,5,0,5,FBS Independents,,West Virginia,1921,N,N
7,2,0,5,Western,,Wisconsin,1921,N,N
9,7,0,2,FBS Independents,,Wofford,1921,N,N
7,4,0,3,Rocky Mountain,,Wyoming,1921,N,N
9,1,0,8,FBS Independents,,Yale,1921,N,N
10,4,0,6,Southern,,Alabama,1922,N,N
9,5,0,4,Southwest,,Arkansas,1922,N,N
10,1,0,9,FBS Independents,,Army,1922,N,N
10,2,0,8,Southern,,Auburn,1922,N,N
11,3,0,8,Southwest,,Baylor,1922,N,N
9,6,0,3,FBS Independents,,Birmingham-Southern,1922,N,N
9,3,0,6,FBS Independents,,Brown,1922,N,N
6,5,0,1,Rocky Mountain,,BYU,1922,N,N
9,0,0,9,Pacific,,California,1922,Y,N
9,4,0,5,FBS Independents,,Carnegie Mellon,1922,N,N
10,2,0,8,FBS Independents,,Centre,1922,N,N
9,3,0,6,FBS Independents,,Chattanooga,1922,N,N
7,2,0,5,Western,,Chicago,1922,N,N
9,4,0,5,Southern,,Clemson,1922,N,N
9,3,0,6,FBS Independents,,Colgate,1922,N,N
8,4,0,4,Rocky Mountain,,Colorado,1922,N,N
7,3,0,4,Rocky Mountain,,Colorado College,1922,N,N
7,2,0,5,Rocky Mountain,,Colorado Mines,1922,N,N
8,3,0,5,Rocky Mountain,,Colorado State,1922,N,N
9,4,0,5,FBS Independents,,Columbia,1922,N,N
8,0,0,8,FBS Independents,,Cornell,1922,Y,N
9,3,0,6,FBS Independents,,Dartmouth,1922,N,N
10,8,0,2,FBS Independents,,Davidson,1922,N,N
8,2,0,6,Rocky Mountain,,Denver,1922,N,N
7,0,0,7,Missouri Valley,,Drake,1922,N,N
10,2,0,8,FBS Independents,,Duke,1922,N,N
8,8,0,0,FBS Independents,,Erskine,1922,N,N
9,2,0,7,Southern,,Florida,1922,N,N
10,5,0,5,FBS Independents,,Fort Benning,1922,N,N
11,3,0,8,FBS Independents,,Furman,1922,N,N
10,4,0,6,Southern,,Georgia,1922,N,N
9,2,0,7,Southern,,Georgia Tech,1922,N,N
8,3,0,5,FBS Independents,,Gonzaga,1922,N,N
8,5,0,3,Missouri Valley,,Grinnell,1922,N,N
9,8,0,1,FBS Independents,,Hampden-Sydney,1922,N,N
9,2,0,7,FBS Independents,,Harvard,1922,N,N
8,5,0,3,Pacific,,Idaho,1922,N,N
7,5,0,2,Western,,Illinois,1922,N,N
7,5,0,2,Western,,Indiana,1922,N,N
7,0,0,7,Western,,Iowa,1922,N,N
8,6,0,2,Missouri Valley,,Iowa State,1922,N,N
8,4,0,4,Missouri Valley,,Kansas,1922,N,N
8,2,0,6,Missouri Valley,,Kansas State,1922,N,N
9,3,0,6,Southern,,Kentucky,1922,N,N
9,2,0,7,FBS Independents,,Lafayette,1922,N,N
9,5,0,4,FBS Independents,,Lehigh,1922,N,N
10,7,0,3,Southern,,LSU,1922,N,N
10,5,0,5,Southern,,Maryland,1922,N,N
11,6,0,5,FBS Independents,,Mercer,1922,N,N
7,0,0,7,Western,,Michigan,1922,N,N
7,3,0,4,Western,,Minnesota,1922,N,N
9,3,0,6,FBS Independents,,Mississippi College,1922,N,N
9,6,0,3,Southern,,Mississippi State,1922,N,N
8,3,0,5,Missouri Valley,,Missouri,1922,N,N
7,2,0,5,FBS Independents,,Navy,1922,N,N
10,6,0,4,Southern,,NC State,1922,N,N
8,1,0,7,Missouri Valley,,Nebraska,1922,N,N
7,5,0,2,FBS Independents,,Newberry,1922,N,N
10,1,0,9,Southern,,North Carolina,1922,N,N
7,4,0,3,Western,,Northwestern,1922,N,N
10,1,0,9,FBS Independents,,Notre Dame,1922,N,N
10,9,0,1,FBS Independents,,Oglethorpe,1922,N,N
7,4,0,3,Western,,Ohio State,1922,N,N
8,4,0,4,Missouri Valley,,Oklahoma,1922,N,N
9,5,0,4,Southwest,,Oklahoma State,1922,N,N
10,6,0,4,Southern,,Ole Miss,1922,N,N
8,1,0,7,Pacific,,Oregon,1922,N,N
7,4,0,3,Pacific,,Oregon State,1922,N,N
11,5,0,6,FBS Independents,,Penn State,1922,N,N
10,2,0,8,FBS Independents,,Pittsburgh,1922,N,N
9,3,0,6,FBS Independents,,Presbyterian College,1922,N,N
8,0,0,8,FBS Independents,,Princeton,1922,Y,N
7,6,0,1,Western,,Purdue,1922,N,N
8,4,0,4,Southwest,,Rice,1922,N,N
9,3,0,6,FBS Independents,,Richmond,1922,N,N
9,4,0,5,FBS Independents,,Rutgers,1922,N,N
10,7,0,3,FBS Independents,,Samford,1922,N,N
8,4,0,4,Southern,,Sewanee Univ. of the South,1922,N,N
10,3,0,7,Southwest,,SMU,1922,N,N
9,4,0,5,Southern,,South Carolina,1922,N,N
8,4,0,4,FBS Independents,,Spring Hill,1922,N,N
9,5,0,4,Pacific,,Stanford,1922,N,N
9,1,0,8,FBS Independents,,Syracuse,1922,N,N
10,6,0,4,FBS Independents,,TCU,1922,N,N
10,2,0,8,Southern,,Tennessee,1922,N,N
9,2,0,7,Southwest,,Texas,1922,N,N
9,4,0,5,Southwest,,Texas A&M,1922,N,N
8,5,0,3,FBS Independents,,The Citadel,1922,N,N
8,4,0,4,Southern,,Tulane,1922,N,N
11,1,0,10,Pacific,,USC,1922,N,N
8,1,0,7,Rocky Mountain,,Utah,1922,N,N
9,4,0,5,Rocky Mountain,,Utah State,1922,N,N
9,1,0,8,Southern,,Vanderbilt,1922,N,N
9,5,0,4,Southern,,Virginia,1922,N,N
10,1,0,9,Southern,,Virginia Tech,1922,N,N
9,2,0,7,FBS Independents,,VMI,1922,N,N
10,5,0,5,FBS Independents,,Wake Forest,1922,N,N
8,2,0,6,Pacific,,Washington,1922,N,N
10,3,0,7,FBS Independents,,Washington & Jefferson,1922,N,N
9,4,0,5,Southern,,Washington & Lee,1922,N,N
7,6,0,1,Missouri Valley,,Washington (MO),1922,N,N
7,5,0,2,Pacific,,Washington State,1922,N,N
11,0,0,11,FBS Independents,,West Virginia,1922,N,N
9,3,0,6,FBS Independents,,William & Mary,1922,N,N
7,2,0,5,Western,,Wisconsin,1922,N,N
9,7,0,2,FBS Independents,,Wofford,1922,N,N
9,8,0,1,Rocky Mountain,,Wyoming,1922,N,N
10,4,0,6,FBS Independents,,Yale,1922,N,N
10,2,0,8,Southern,,Alabama,1923,N,N
9,3,0,6,Southwest,,Arkansas,1923,N,N
9,3,0,6,FBS Independents,,Army,1923,N,N
9,4,0,5,Southern,,Auburn,1923,N,N
8,3,0,5,Southwest,,Baylor,1923,N,N
7,6,0,1,FBS Independents,,Boston University,1923,N,N
10,4,0,6,FBS Independents,,Brown,1923,N,N
7,5,0,2,Rocky Mountain,,BYU,1923,N,N
10,1,0,9,Pacific,,California,1923,N,N
8,3,0,5,FBS Independents,,Carnegie Mellon,1923,N,N
9,1,0,8,FBS Independents,,Centre,1923,N,N
9,6,0,3,FBS Independents,,Chattanooga,1923,N,N
8,1,0,7,Western,,Chicago,1923,N,N
8,3,0,5,Southern,,Clemson,1923,N,N
9,2,0,7,FBS Independents,,Colgate,1923,N,N
9,0,0,9,Rocky Mountain,,Colorado,1923,N,N
8,2,0,6,Rocky Mountain,,Colorado College,1923,N,N
7,5,0,2,Rocky Mountain,,Colorado Mines,1923,N,N
8,2,0,6,Rocky Mountain,,Colorado State,1923,N,N
9,5,0,4,FBS Independents,,Columbia,1923,N,N
8,0,0,8,FBS Independents,,Cornell,1923,N,N
9,1,0,8,FBS Independents,,Dartmouth,1923,N,N
10,7,0,3,FBS Independents,,Davidson,1923,N,N
9,3,0,6,Rocky Mountain,,Denver,1923,N,N
7,2,0,5,Missouri Valley,,Drake,1923,N,N
9,4,0,5,FBS Independents,,Duke,1923,N,N
9,2,0,7,Southern,,Florida,1923,N,N
11,1,0,10,FBS Independents,,Furman,1923,N,N
9,4,0,5,Southern,,Georgia,1923,N,N
9,6,0,3,Southern,,Georgia Tech,1923,N,N
7,3,0,4,FBS Independents,,Gonzaga,1923,N,N
8,6,0,2,Missouri Valley,,Grinnell,1923,N,N
8,4,0,4,FBS Independents,,Harvard,1923,N,N
8,3,0,5,Pacific,,Idaho,1923,N,N
8,0,0,8,Western,,Illinois,1923,Y,N
7,4,0,3,Western,,Indiana,1923,N,N
8,3,0,5,Western,,Iowa,1923,N,N
8,4,0,4,Missouri Valley,,Iowa State,1923,N,N
8,2,0,6,Missouri Valley,,Kansas,1923,N,N
8,2,0,6,Missouri Valley,,Kansas State,1923,N,N
9,4,0,5,Southern,,Kentucky,1923,N,N
9,3,0,6,FBS Independents,,Lafayette,1923,N,N
9,2,0,7,FBS Independents,,Lehigh,1923,N,N
9,5,0,4,Southern,,LSU,1923,N,N
10,2,0,8,Southern,,Maryland,1923,N,N
9,6,0,3,FBS Independents,,Mercer,1923,N,N
8,0,0,8,Western,,Michigan,1923,Y,N
7,1,0,6,Western,,Minnesota,1923,N,N
8,3,0,5,FBS Independents,,Mississippi College,1923,N,N
9,2,0,7,Southern,,Mississippi State,1923,N,N
8,4,0,4,Missouri Valley,,Missouri,1923,N,N
8,4,0,4,FBS Independents,,Montana,1923,N,N
9,4,0,5,Rocky Mountain,,Montana State,1923,N,N
9,3,0,6,FBS Independents,,Navy,1923,N,N
10,7,0,3,Southern,,NC State,1923,N,N
8,3,0,5,Missouri Valley,,Nebraska,1923,N,N
10,8,0,2,FBS Independents,,Newberry,1923,N,N
9,4,0,5,Southern,,North Carolina,1923,N,N
6,4,0,2,Rocky Mountain,,Northern Colorado,1923,N,N
8,6,0,2,Western,,Northwestern,1923,N,N
10,1,0,9,FBS Independents,,Notre Dame,1923,N,N
11,6,0,5,FBS Independents,,Oglethorpe,1923,N,N
8,5,0,3,Western,,Ohio State,1923,N,N
8,5,0,3,Missouri Valley,,Oklahoma,1923,N,N
10,8,0,2,Southwest,,Oklahoma State,1923,N,N
10,6,0,4,Southern,,Ole Miss,1923,N,N
8,4,0,4,Pacific,,Oregon,1923,N,N
11,6,0,5,Pacific,,Oregon State,1923,N,N
9,3,0,6,FBS Independents,,Penn State,1923,N,N
9,4,0,5,FBS Independents,,Pittsburgh,1923,N,N
8,4,0,4,FBS Independents,,Presbyterian College,1923,N,N
7,3,0,4,FBS Independents,,Princeton,1923,N,N
8,6,0,2,Western,,Purdue,1923,N,N
8,5,0,3,Southwest,,Rice,1923,N,N
8,5,0,3,FBS Independents,,Richmond,1923,N,N
9,1,0,8,FBS Independents,,Rutgers,1923,N,N
10,5,0,5,FBS Independents,,Samford,1923,N,N
10,5,0,5,Southern,,Sewanee Univ. of the South,1923,N,N
9,0,0,9,Southwest,,SMU,1923,N,N
10,6,0,4,Southern,,South Carolina,1923,N,N
9,2,0,7,Pacific,,Stanford,1923,N,N
9,1,0,8,FBS Independents,,Syracuse,1923,N,N
9,5,0,4,Southwest,,TCU,1923,N,N
10,5,0,5,Southern,,Tennessee,1923,N,N
9,0,0,9,Southwest,,Texas,1923,N,N
9,3,0,6,Southwest,,Texas A&M,1923,N,N
9,3,0,6,FBS Independents,,The Citadel,1923,N,N
10,3,0,7,Southern,,Tulane,1923,N,N
8,2,0,6,Pacific,,USC,1923,N,N
7,3,0,4,Rocky Mountain,,Utah,1923,N,N
7,2,0,5,Rocky Mountain,,Utah State,1923,N,N
8,3,0,5,Southern,,Vanderbilt,1923,N,N
9,5,0,4,Southern,,Virginia,1923,N,N
9,3,0,6,Southern,,Virginia Tech,1923,N,N
10,1,0,9,FBS Independents,,VMI,1923,N,N
9,3,0,6,FBS Independents,,Wake Forest,1923,N,N
12,1,0,11,Pacific,,Washington,1923,N,N
8,1,0,7,FBS Independents,,Washington & Jefferson,1923,N,N
9,2,0,7,Southern,,Washington & Lee,1923,N,N
8,5,0,3,Missouri Valley,,Washington (MO),1923,N,N
7,5,0,2,Pacific,,Washington State,1923,N,N
9,1,0,8,FBS Independents,,West Virginia,1923,N,N
6,5,0,1,FBS Independents,,Whitman,1923,N,N
10,3,0,7,FBS Independents,,William & Mary,1923,N,N
7,4,0,3,Western,,Wisconsin,1923,N,N
9,3,0,6,FBS Independents,,Wofford,1923,N,N
8,8,0,0,Rocky Mountain,,Wyoming,1923,N,N
8,0,0,8,FBS Independents,,Yale,1923,N,N
9,1,0,8,Southern,,Alabama,1924,N,N
10,3,0,7,Southwest,,Arkansas,1924,N,N
8,2,0,6,FBS Independents,,Army,1924,N,N
9,4,0,5,Southern,,Auburn,1924,N,N
10,2,0,8,Southwest,,Baylor,1924,N,N
9,4,0,5,FBS Independents,,Birmingham-Southern,1924,N,N
6,5,0,1,FBS Independents,,Boston University,1924,N,N
9,4,0,5,FBS Independents,,Brown,1924,N,N
6,3,0,3,Rocky Mountain,,BYU,1924,N,N
10,1,0,9,Pacific,,California,1924,N,N
9,4,0,5,FBS Independents,,Carnegie Mellon,1924,N,N
7,2,0,5,FBS Independents,,Centre,1924,N,N
9,8,0,1,FBS Independents,,Chattanooga,1924,N,N
8,3,0,5,Western,,Chicago,1924,N,N
8,6,0,2,Southern,,Clemson,1924,N,N
9,4,0,5,FBS Independents,,Colgate,1924,N,N
10,1,0,9,Rocky Mountain,,Colorado,1924,N,N
8,3,0,5,Rocky Mountain,,Colorado College,1924,N,N
9,5,0,4,Rocky Mountain,,Colorado Mines,1924,N,N
6,2,0,4,Rocky Mountain,,Colorado State,1924,N,N
9,3,0,6,FBS Independents,,Columbia,1924,N,N
8,4,0,4,FBS Independents,,Cornell,1924,N,N
8,0,0,8,FBS Independents,,Dartmouth,1924,N,N
10,3,0,7,FBS Independents,,Davidson,1924,N,N
8,4,0,4,Rocky Mountain,,Denver,1924,N,N
8,3,0,5,Missouri Valley,,Drake,1924,N,N
9,5,0,4,FBS Independents,,Duke,1924,N,N
7,7,0,0,FBS Independents,,Erskine,1924,N,N
10,2,0,8,Southern,,Florida,1924,N,N
10,5,0,5,FBS Independents,,Furman,1924,N,N
10,3,0,7,Southern,,Georgia,1924,N,N
9,4,0,5,Southern,,Georgia Tech,1924,N,N
7,2,0,5,FBS Independents,,Gonzaga,1924,N,N
6,3,0,3,Missouri Valley,,Grinnell,1924,N,N
8,4,0,4,FBS Independents,,Harvard,1924,N,N
8,2,0,6,Pacific,,Idaho,1924,N,N
8,1,0,7,Western,,Illinois,1924,N,N
8,4,0,4,Western,,Indiana,1924,N,N
8,2,0,6,Western,,Iowa,1924,N,N
8,3,0,5,Missouri Valley,,Iowa State,1924,N,N
8,5,0,3,Missouri Valley,,Kansas,1924,N,N
8,4,0,4,Missouri Valley,,Kansas State,1924,N,N
9,5,0,4,Southern,,Kentucky,1924,N,N
9,4,0,5,Southern,,LSU,1924,N,N
9,4,0,5,Southern,,Maryland,1924,N,N
10,3,0,7,FBS Independents,,Mercer,1924,N,N
8,2,0,6,Western,,Michigan,1924,N,N
9,5,0,4,FBS Independents,,Millsaps,1924,N,N
8,4,0,4,Western,,Minnesota,1924,N,N
8,6,0,2,FBS Independents,,Mississippi College,1924,N,N
9,4,0,5,Southern,,Mississippi State,1924,N,N
9,2,0,7,Missouri Valley,,Missouri,1924,N,N
8,4,0,4,Pacific,,Montana,1924,N,N
7,1,0,6,Rocky Mountain,,Montana State,1924,N,N
8,6,0,2,FBS Independents,,Navy,1924,N,N
10,6,0,4,Southern,,NC State,1924,N,N
8,3,0,5,Missouri Valley,,Nebraska,1924,N,N
10,2,0,8,FBS Independents,,Newberry,1924,N,N
9,5,0,4,Southern,,North Carolina,1924,N,N
7,5,0,2,Rocky Mountain,,Northern Colorado,1924,N,N
8,4,0,4,Western,,Northwestern,1924,N,N
10,0,0,10,FBS Independents,,Notre Dame,1924,Y,N
10,3,0,7,FBS Independents,,Oglethorpe,1924,N,N
8,5,0,3,Western,,Ohio State,1924,N,N
8,6,0,2,Missouri Valley,,Oklahoma,1924,N,N
9,1,0,8,Southwest,,Oklahoma State,1924,N,N
9,5,0,4,Southern,,Ole Miss,1924,N,N
9,3,0,6,Pacific,,Oregon,1924,N,N
8,5,0,3,Pacific,,Oregon State,1924,N,N
10,3,0,7,FBS Independents,,Penn State,1924,N,N
9,3,0,6,FBS Independents,,Pittsburgh,1924,N,N
8,6,0,2,FBS Independents,,Presbyterian College,1924,N,N
7,3,0,4,FBS Independents,,Princeton,1924,N,N
7,2,0,5,Western,,Purdue,1924,N,N
7,6,0,1,FBS Independents,,Regis (CO),1924,N,N
8,4,0,4,Southwest,,Rice,1924,N,N
9,7,0,2,FBS Independents,,Richmond,1924,N,N
9,6,0,3,FBS Independents,,Samford,1924,N,N
10,5,0,5,Southern,,Sewanee Univ. of the South,1924,N,N
10,4,0,6,Southwest,,SMU,1924,N,N
10,3,0,7,Southern,,South Carolina,1924,N,N
9,1,0,8,Pacific,,Stanford,1924,N,N
11,3,0,8,FBS Independents,,Syracuse,1924,N,N
9,5,0,4,Southwest,,TCU,1924,N,N
8,5,0,3,Southern,,Tennessee,1924,N,N
9,4,0,5,Southwest,,Texas,1924,N,N
10,2,0,8,Southwest,,Texas A&M,1924,N,N
10,4,0,6,FBS Independents,,The Citadel,1924,N,N
9,1,0,8,Southern,,Tulane,1924,N,N
11,2,0,9,Pacific,,USC,1924,N,N
8,5,0,3,Rocky Mountain,,Utah,1924,N,N
7,2,0,5,Rocky Mountain,,Utah State,1924,N,N
10,3,0,7,Southern,,Vanderbilt,1924,N,N
9,4,0,5,Southern,,Virginia,1924,N,N
9,4,0,5,Southern,,Virginia Tech,1924,N,N
10,4,0,6,Southern,,VMI,1924,N,N
9,2,0,7,FBS Independents,,Wake Forest,1924,N,N
10,2,0,8,Pacific,,Washington,1924,N,N
9,2,0,7,FBS Independents,,Washington & Jefferson,1924,N,N
10,3,0,7,Southern,,Washington & Lee,1924,N,N
8,4,0,4,Missouri Valley,,Washington (MO),1924,N,N
8,5,0,3,Pacific,,Washington State,1924,N,N
6,4,0,2,FBS Independents,,Western State,1924,N,N
9,1,0,8,FBS Independents,,West Virginia,1924,N,N
6,5,0,1,FBS Independents,,Whitman,1924,N,N
9,2,0,7,FBS Independents,,William & Mary,1924,N,N
8,5,0,3,Western,,Wisconsin,1924,N,N
10,7,0,3,FBS Independents,,Wofford,1924,N,N
8,6,0,2,Rocky Mountain,,Wyoming,1924,N,N
8,2,0,6,FBS Independents,,Yale,1924,N,N
10,0,0,10,Southern,,Alabama,1925,Y,N
9,4,0,5,Southwest,,Arkansas,1925,N,N
9,2,0,7,FBS Independents,,Army,1925,N,N
9,3,0,6,Southern,,Auburn,1925,N,N
10,5,0,5,Southwest,,Baylor,1925,N,N
10,5,0,5,FBS Independents,,Brown,1925,N,N
6,3,0,3,Rocky Mountain,,BYU,1925,N,N
9,3,0,6,Pacific,,California,1925,N,N
8,2,0,6,FBS Independents,,Carnegie Mellon,1925,N,N
9,6,0,3,FBS Independents,,Centre,1925,N,N
8,5,0,3,Western,,Chicago,1925,N,N
8,7,0,1,Southern,,Clemson,1925,N,N
9,0,0,9,FBS Independents,,Colgate,1925,N,N
9,3,0,6,Rocky Mountain,,Colorado,1925,N,N
10,5,0,5,Rocky Mountain,,Colorado College,1925,N,N
9,7,0,2,Rocky Mountain,,Colorado Mines,1925,N,N
10,1,0,9,Rocky Mountain,,Colorado State,1925,N,N
10,4,0,6,FBS Independents,,Columbia,1925,N,N
8,2,0,6,FBS Independents,,Cornell,1925,N,N
8,0,0,8,FBS Independents,,Dartmouth,1925,N,N
10,4,0,6,FBS Independents,,Davidson,1925,N,N
7,6,0,1,Rocky Mountain,,Denver,1925,N,N
8,3,0,5,Missouri Valley,,Drake,1925,N,N
9,5,0,4,FBS Independents,,Duke,1925,N,N
10,2,0,8,Southern,,Florida,1925,N,N
10,3,0,7,FBS Independents,,Furman,1925,N,N
9,5,0,4,Southern,,Georgia,1925,N,N
9,3,0,6,Southern,,Georgia Tech,1925,N,N
11,4,0,7,FBS Independents,,Gonzaga,1925,N,N
8,4,0,4,Missouri Valley,,Grinnell,1925,N,N
9,5,0,4,FBS Independents,,Hampden-Sydney,1925,N,N
8,4,0,4,FBS Independents,,Harvard,1925,N,N
8,5,0,3,Pacific,,Idaho,1925,N,N
8,3,0,5,Western,,Illinois,1925,N,N
8,5,0,3,Western,,Indiana,1925,N,N
8,3,0,5,Western,,Iowa,1925,N,N
8,4,0,4,Missouri Valley,,Iowa State,1925,N,N
8,5,0,3,Missouri Valley,,Kansas,1925,N,N
8,3,0,5,Missouri Valley,,Kansas State,1925,N,N
9,3,0,6,Southern,,Kentucky,1925,N,N
9,3,0,6,Southern,,LSU,1925,N,N
8,5,0,3,Southern,,Maryland,1925,N,N
9,5,0,4,FBS Independents,,Mercer,1925,N,N
8,1,0,7,Western,,Michigan,1925,N,N
8,5,0,3,FBS Independents,,Michigan State,1925,N,N
8,3,0,5,Western,,Minnesota,1925,N,N
8,5,0,3,Southern,,Mississippi State,1925,N,N
8,1,0,7,Missouri Valley,,Missouri,1925,N,N
8,4,0,4,Pacific,,Montana,1925,N,N
11,5,0,6,Rocky Mountain,,Montana State,1925,N,N
8,3,0,5,FBS Independents,,Navy,1925,N,N
9,5,0,4,Southern,,NC State,1925,N,N
8,3,0,5,Missouri Valley,,Nebraska,1925,N,N
8,3,0,5,FBS Independents,,Newberry,1925,N,N
9,2,0,7,Southern,,North Carolina,1925,N,N
9,6,0,3,Rocky Mountain,,Northern Colorado,1925,N,N
8,3,0,5,Western,,Northwestern,1925,N,N
10,2,0,8,FBS Independents,,Notre Dame,1925,N,N
11,3,0,8,FBS Independents,,Oglethorpe,1925,N,N
8,3,0,5,Western,,Ohio State,1925,N,N
8,4,0,4,Missouri Valley,,Oklahoma,1925,N,N
8,5,0,3,Missouri Valley,,Oklahoma State,1925,N,N
10,5,0,5,Southern,,Ole Miss,1925,N,N
7,6,0,1,Pacific,,Oregon,1925,N,N
9,2,0,7,Pacific,,Oregon State,1925,N,N
9,5,0,4,FBS Independents,,Penn State,1925,N,N
9,1,0,8,FBS Independents,,Pittsburgh,1925,N,N
9,6,0,3,FBS Independents,,Presbyterian College,1925,N,N
7,1,0,6,FBS Independents,,Princeton,1925,N,N
8,4,0,4,Western,,Purdue,1925,N,N
9,5,0,4,Southwest,,Rice,1925,N,N
9,6,0,3,FBS Independents,,Richmond,1925,N,N
9,4,0,5,Southern,,Sewanee Univ. of the South,1925,N,N
9,4,0,5,Southwest,,SMU,1925,N,N
10,3,0,7,Southern,,South Carolina,1925,N,N
9,2,0,7,Pacific,,Stanford,1925,N,N
10,2,0,8,FBS Independents,,Syracuse,1925,N,N
9,2,0,7,Southwest,,TCU,1925,N,N
8,3,0,5,Southern,,Tennessee,1925,N,N
9,2,0,7,Southwest,,Texas,1925,N,N
9,2,0,7,Southwest,,Texas A&M,1925,N,N
10,4,0,6,FBS Independents,,The Citadel,1925,N,N
10,1,0,9,Southern,,Tulane,1925,N,N
13,2,0,11,Pacific,,USC,1925,N,N
8,2,0,6,Rocky Mountain,,Utah,1925,N,N
7,1,0,6,Rocky Mountain,,Utah State,1925,N,N
9,3,0,6,Southern,,Vanderbilt,1925,N,N
9,1,0,8,Southern,,Virginia,1925,N,N
10,5,0,5,Southern,,Virginia Tech,1925,N,N
10,5,0,5,Southern,,VMI,1925,N,N
9,2,0,7,FBS Independents,,Wake Forest,1925,N,N
12,1,0,11,Pacific,,Washington,1925,N,N
9,3,0,6,FBS Independents,,Washington & Jefferson,1925,N,N
10,5,0,5,Southern,,Washington & Lee,1925,N,N
8,6,0,2,Missouri Valley,,Washington (MO),1925,N,N
8,4,0,4,Pacific,,Washington State,1925,N,N
7,4,0,3,Rocky Mountain,,Western State,1925,N,N
9,1,0,8,FBS Independents,,West Virginia,1925,N,N
11,4,0,7,FBS Independents,,William & Mary,1925,N,N
8,1,0,7,Western,,Wisconsin,1925,N,N
10,7,0,3,FBS Independents,,Wofford,1925,N,N
9,3,0,6,Rocky Mountain,,Wyoming,1925,N,N
8,2,0,6,FBS Independents,,Yale,1925,N,N
10,1,0,9,Southern,,Alabama,1926,Y,N
10,5,0,5,Southwest,,Arkansas,1926,N,N
9,2,0,7,FBS Independents,,Army,1926,N,N
9,4,0,5,Southern,,Auburn,1926,N,N
10,3,0,7,Southwest,,Baylor,1926,N,N
10,1,0,9,FBS Independents,,Brown,1926,N,N
7,6,0,1,Rocky Mountain,,BYU,1926,N,N
9,6,0,3,Pacific,,California,1926,N,N
9,2,0,7,FBS Independents,,Carnegie Mellon,1926,N,N
8,6,0,2,Western,,Chicago,1926,N,N
9,7,0,2,Southern,,Clemson,1926,N,N
9,2,0,7,FBS Independents,,Colgate,1926,N,N
9,6,0,3,Rocky Mountain,,Colorado,1926,N,N
7,2,0,5,Rocky Mountain,,Colorado College,1926,N,N
7,6,0,1,Rocky Mountain,,Colorado Mines,1926,N,N
9,2,0,7,Rocky Mountain,,Colorado State,1926,N,N
9,3,0,6,FBS Independents,,Columbia,1926,N,N
8,1,0,7,FBS Independents,,Cornell,1926,N,N
8,4,0,4,FBS Independents,,Dartmouth,1926,N,N
10,3,0,7,FBS Independents,,Davidson,1926,N,N
8,4,0,4,Rocky Mountain,,Denver,1926,N,N
8,6,0,2,Missouri Valley,,Drake,1926,N,N
9,6,0,3,FBS Independents,,Duke,1926,N,N
10,8,0,2,Southern,,Florida,1926,N,N
10,2,0,8,FBS Independents,,Furman,1926,N,N
9,4,0,5,Southern,,Georgia,1926,N,N
9,5,0,4,Southern,,Georgia Tech,1926,N,N
8,2,0,6,Missouri Valley,,Grinnell,1926,N,N
8,5,0,3,FBS Independents,,Harvard,1926,N,N
8,5,0,3,Pacific,,Idaho,1926,N,N
8,2,0,6,Western,,Illinois,1926,N,N
8,5,0,3,Western,,Indiana,1926,N,N
8,5,0,3,Western,,Iowa,1926,N,N
8,3,0,5,Missouri Valley,,Iowa State,1926,N,N
8,6,0,2,Missouri Valley,,Kansas,1926,N,N
8,3,0,5,Missouri Valley,,Kansas State,1926,N,N
9,7,0,2,Southern,,Kentucky,1926,N,N
9,3,0,6,Southern,,LSU,1926,N,N
10,5,0,5,Southern,,Maryland,1926,N,N
8,1,0,7,Western,,Michigan,1926,N,N
8,5,0,3,FBS Independents,,Michigan State,1926,N,N
8,3,0,5,Western,,Minnesota,1926,N,N
9,4,0,5,Southern,,Mississippi State,1926,N,N
8,3,0,5,Missouri Valley,,Missouri,1926,N,N
8,5,0,3,Pacific,,Montana,1926,N,N
7,2,0,5,Rocky Mountain,,Montana State,1926,N,N
10,0,0,10,FBS Independents,,Navy,1926,N,N
10,6,0,4,Southern,,NC State,1926,N,N
8,2,0,6,Missouri Valley,,Nebraska,1926,N,N
9,5,0,4,Southern,,North Carolina,1926,N,N
10,4,0,6,Rocky Mountain,,Northern Colorado,1926,N,N
8,1,0,7,Western,,Northwestern,1926,N,N
10,1,0,9,FBS Independents,,Notre Dame,1926,N,N
8,1,0,7,Western,,Ohio State,1926,N,N
8,2,0,6,Missouri Valley,,Oklahoma,1926,N,N
8,5,0,3,Missouri Valley,,Oklahoma State,1926,N,N
9,4,0,5,Southern,,Ole Miss,1926,N,N
7,5,0,2,Pacific,,Oregon,1926,N,N
8,1,0,7,Pacific,,Oregon State,1926,N,N
9,4,0,5,FBS Independents,,Penn State,1926,N,N
9,4,0,5,FBS Independents,,Pittsburgh,1926,N,N
9,2,0,7,FBS Independents,,Presbyterian College,1926,N,N
7,2,0,5,FBS Independents,,Princeton,1926,N,N
8,3,0,5,Western,,Purdue,1926,N,N
9,5,0,4,Southwest,,Rice,1926,N,N
8,6,0,2,Southern,,Sewanee Univ. of the South,1926,N,N
9,0,0,9,Southwest,,SMU,1926,N,N
10,4,0,6,Southern,,South Carolina,1926,N,N
11,0,0,11,Pacific,,Stanford,1926,Y,N
10,3,0,7,FBS Independents,,Syracuse,1926,N,N
9,2,0,7,Southwest,,TCU,1926,N,N
9,1,0,8,Southern,,Tennessee,1926,N,N
9,4,0,5,Southwest,,Texas,1926,N,N
9,4,0,5,Southwest,,Texas A&M,1926,N,N
10,3,0,7,FBS Independents,,The Citadel,1926,N,N
9,5,0,4,Southern,,Tulane,1926,N,N
10,2,0,8,Pacific,,USC,1926,N,N
7,0,0,7,Rocky Mountain,,Utah,1926,N,N
8,1,0,7,Rocky Mountain,,Utah State,1926,N,N
9,1,0,8,Southern,,Vanderbilt,1926,N,N
10,3,0,7,Southern,,Virginia,1926,N,N
9,3,0,6,Southern,,Virginia Tech,1926,N,N
10,5,0,5,Southern,,VMI,1926,N,N
10,4,0,6,FBS Independents,,Wake Forest,1926,N,N
10,2,0,8,Pacific,,Washington,1926,N,N
9,1,0,8,FBS Independents,,Washington & Jefferson,1926,N,N
9,3,0,6,Southern,,Washington & Lee,1926,N,N
8,7,0,1,Missouri Valley,,Washington (MO),1926,N,N
7,1,0,6,Pacific,,Washington State,1926,N,N
8,8,0,0,Rocky Mountain,,Western State,1926,N,N
10,4,0,6,FBS Independents,,West Virginia,1926,N,N
8,2,0,6,Western,,Wisconsin,1926,N,N
10,8,0,2,FBS Independents,,Wofford,1926,N,N
8,5,0,3,Rocky Mountain,,Wyoming,1926,N,N
8,4,0,4,FBS Independents,,Yale,1926,N,N
10,5,0,5,Southern,,Alabama,1927,N,N
9,1,0,8,Southwest,,Arkansas,1927,N,N
10,1,0,9,FBS Independents,,Army,1927,N,N
9,7,0,2,Southern,,Auburn,1927,N,N
9,7,0,2,Southwest,,Baylor,1927,N,N
10,7,0,3,FBS Independents,,Brown,1927,N,N
7,4,0,3,Rocky Mountain,,BYU,1927,N,N
10,3,0,7,Pacific,,California,1927,N,N
10,4,0,6,FBS Independents,,Carnegie Mellon,1927,N,N
8,4,0,4,Western,,Chicago,1927,N,N
9,4,0,5,Southern,,Clemson,1927,N,N
9,2,0,7,FBS Independents,,Colgate,1927,N,N
9,5,0,4,Rocky Mountain,,Colorado,1927,N,N
8,2,0,6,Rocky Mountain,,Colorado College,1927,N,N
7,5,0,2,Rocky Mountain,,Colorado Mines,1927,N,N
8,1,0,7,Rocky Mountain,,Colorado State,1927,N,N
9,3,0,6,FBS Independents,,Columbia,1927,N,N
8,5,0,3,FBS Independents,,Cornell,1927,N,N
8,1,0,7,FBS Independents,,Creighton,1927,N,N
8,1,0,7,FBS Independents,,Dartmouth,1927,N,N
9,4,0,5,FBS Independents,,Davidson,1927,N,N
7,2,0,5,Rocky Mountain,,Denver,1927,N,N
9,2,0,7,FBS Independents,,Detroit Mercy,1927,N,N
9,6,0,3,Missouri Valley,,Drake,1927,N,N
9,5,0,4,FBS Independents,,Duke,1927,N,N
10,3,0,7,Southern,,Florida,1927,N,N
11,1,0,10,FBS Independents,,Furman,1927,N,N
9,1,0,8,FBS Independents,,Georgetown,1927,N,N
10,1,0,9,Southern,,Georgia,1927,N,N
10,1,0,9,Southern,,Georgia Tech,1927,N,N
8,8,0,0,Missouri Valley,,Grinnell,1927,N,N
8,4,0,4,FBS Independents,,Harvard,1927,N,N
8,2,0,6,Pacific,,Idaho,1927,N,N
8,1,0,7,Western,,Illinois,1927,Y,N
8,5,0,3,Western,,Indiana,1927,N,N
8,4,0,4,Western,,Iowa,1927,N,N
8,3,0,5,Missouri Valley,,Iowa State,1927,N,N
8,5,0,3,Missouri Valley,,Kansas,1927,N,N
8,5,0,3,Missouri Valley,,Kansas State,1927,N,N
10,7,0,3,Southern,,Kentucky,1927,N,N
9,3,0,6,FBS Independents,,Lafayette,1927,N,N
9,4,0,5,Southern,,LSU,1927,N,N
9,3,0,6,FBS Independents,,Marquette,1927,N,N
11,7,0,4,Southern,,Maryland,1927,N,N
8,2,0,6,Western,,Michigan,1927,N,N
9,5,0,4,FBS Independents,,Michigan State,1927,N,N
8,0,0,8,Western,,Minnesota,1927,N,N
8,3,0,5,Southern,,Mississippi State,1927,N,N
9,2,0,7,Missouri Valley,,Missouri,1927,N,N
8,5,0,3,Pacific,,Montana,1927,N,N
8,4,0,4,Rocky Mountain,,Montana State,1927,N,N
9,3,0,6,FBS Independents,,Navy,1927,N,N
10,1,0,9,Southern,,NC State,1927,N,N
8,2,0,6,Missouri Valley,,Nebraska,1927,N,N
10,2,0,8,FBS Independents,,New York University,1927,N,N
10,6,0,4,Southern,,North Carolina,1927,N,N
9,7,0,2,Rocky Mountain,,Northern Colorado,1927,N,N
8,4,0,4,Western,,Northwestern,1927,N,N
9,2,0,7,FBS Independents,,Notre Dame,1927,N,N
8,4,0,4,Western,,Ohio State,1927,N,N
8,4,0,4,Missouri Valley,,Oklahoma,1927,N,N
8,4,0,4,Missouri Valley,,Oklahoma State,1927,N,N
9,4,0,5,Southern,,Ole Miss,1927,N,N
7,5,0,2,Pacific,,Oregon,1927,N,N
7,4,0,3,Pacific,,Oregon State,1927,N,N
9,3,0,6,FBS Independents,,Penn State,1927,N,N
10,2,0,8,FBS Independents,,Pittsburgh,1927,N,N
7,1,0,6,FBS Independents,,Princeton,1927,N,N
8,2,0,6,Western,,Purdue,1927,N,N
9,7,0,2,Southwest,,Rice,1927,N,N
8,6,0,2,Southern,,Sewanee Univ. of the South,1927,N,N
9,2,0,7,Southwest,,SMU,1927,N,N
9,5,0,4,Southern,,South Carolina,1927,N,N
11,3,0,8,Pacific,,Stanford,1927,N,N
10,5,0,5,FBS Independents,,Syracuse,1927,N,N
9,4,0,5,Southwest,,TCU,1927,N,N
9,1,0,8,Southern,,Tennessee,1927,N,N
9,3,0,6,Southwest,,Texas,1927,N,N
9,0,0,9,Southwest,,Texas A&M,1927,N,N
8,6,0,2,Southern,,Tulane,1927,N,N
10,1,0,9,Pacific,,USC,1927,N,N
7,4,0,3,Rocky Mountain,,Utah,1927,N,N
8,4,0,4,Rocky Mountain,,Utah State,1927,N,N
11,2,0,9,Southern,,Vanderbilt,1927,N,N
9,4,0,5,Southern,,Virginia,1927,N,N
9,4,0,5,Southern,,Virginia Tech,1927,N,N
10,4,0,6,Southern,,VMI,1927,N,N
10,8,0,2,FBS Independents,,Wake Forest,1927,N,N
11,2,0,9,Pacific,,Washington,1927,N,N
9,0,0,9,FBS Independents,,Washington & Jefferson,1927,N,N
9,5,0,4,Southern,,Washington & Lee,1927,N,N
9,3,0,6,Missouri Valley,,Washington (MO),1927,N,N
8,5,0,3,Pacific,,Washington State,1927,N,N
7,6,0,1,Rocky Mountain,,Western State,1927,N,N
9,6,0,3,FBS Independents,,West Virginia,1927,N,N
8,4,0,4,Western,,Wisconsin,1927,N,N
9,5,0,4,Rocky Mountain,,Wyoming,1927,N,N
8,1,0,7,FBS Independents,,Yale,1927,Y,N
9,3,0,6,Southern,,Alabama,1928,N,N
9,2,0,7,Southwest,,Arkansas,1928,N,N
10,2,0,8,FBS Independents,,Army,1928,N,N
9,8,0,1,Southern,,Auburn,1928,N,N
10,2,0,8,Southwest,,Baylor,1928,N,N
9,1,0,8,FBS Independents,,Brown,1928,N,N
7,3,0,4,Rocky Mountain,,BYU,1928,N,N
10,4,0,6,Pacific,,California,1928,N,N
8,1,0,7,FBS Independents,,Carnegie Mellon,1928,N,N
9,7,0,2,Western,,Chicago,1928,N,N
11,3,0,8,Southern,,Clemson,1928,N,N
9,3,0,6,FBS Independents,,Colgate,1928,N,N
6,1,0,5,Rocky Mountain,,Colorado,1928,N,N
8,3,0,5,Rocky Mountain,,Colorado College,1928,N,N
7,5,0,2,Rocky Mountain,,Colorado Mines,1928,N,N
8,2,0,6,Rocky Mountain,,Colorado State,1928,N,N
9,4,0,5,FBS Independents,,Columbia,1928,N,N
8,4,0,4,FBS Independents,,Cornell,1928,N,N
9,6,0,3,Missouri Valley,,Creighton,1928,N,N
9,4,0,5,FBS Independents,,Dartmouth,1928,N,N
10,8,0,2,FBS Independents,,Davidson,1928,N,N
9,5,0,4,Rocky Mountain,,Denver,1928,N,N
9,0,0,9,FBS Independents,,Detroit Mercy,1928,N,N
8,1,0,7,Missouri Valley,,Drake,1928,N,N
10,5,0,5,Southern,,Duke,1928,N,N
9,1,0,8,Southern,,Florida,1928,N,N
9,5,0,4,FBS Independents,,Fordham,1928,N,N
9,4,0,5,FBS Independents,,Furman,1928,N,N
10,2,0,8,FBS Independents,,Georgetown,1928,N,N
9,5,0,4,Southern,,Georgia,1928,N,N
10,0,0,10,Southern,,Georgia Tech,1928,Y,N
8,3,0,5,Missouri Valley,,Grinnell,1928,N,N
8,3,0,5,FBS Independents,,Harvard,1928,N,N
8,5,0,3,Pacific,,Idaho,1928,N,N
8,1,0,7,Western,,Illinois,1928,N,N
8,4,0,4,Western,,Indiana,1928,N,N
8,2,0,6,Western,,Iowa,1928,N,N
8,5,0,3,Big 6,,Iowa State,1928,N,N
8,5,0,3,Big 6,,Kansas,1928,N,N
8,5,0,3,Big 6,,Kansas State,1928,N,N
8,3,0,5,Southern,,Kentucky,1928,N,N
9,2,0,7,Southern,,LSU,1928,N,N
9,3,0,6,FBS Independents,,Marquette,1928,N,N
10,4,0,6,Southern,,Maryland,1928,N,N
8,4,0,4,Western,,Michigan,1928,N,N
8,5,0,3,FBS Independents,,Michigan State,1928,N,N
8,2,0,6,Western,,Minnesota,1928,N,N
8,5,0,3,Southern,,Mississippi State,1928,N,N
8,4,0,4,Big 6,,Missouri,1928,N,N
10,6,0,4,Pacific,,Montana,1928,N,N
9,4,0,5,Rocky Mountain,,Montana State,1928,N,N
9,4,0,5,FBS Independents,,Navy,1928,N,N
10,6,0,4,Southern,,NC State,1928,N,N
9,2,0,7,Big 6,,Nebraska,1928,N,N
10,2,0,8,FBS Independents,,New York University,1928,N,N
10,4,0,6,Southern,,North Carolina,1928,N,N
8,4,0,4,Rocky Mountain,,Northern Colorado,1928,N,N
8,3,0,5,Western,,Northwestern,1928,N,N
9,4,0,5,FBS Independents,,Notre Dame,1928,N,N
8,3,0,5,Western,,Ohio State,1928,N,N
8,3,0,5,Big 6,,Oklahoma,1928,N,N
8,7,0,1,Missouri Valley,,Oklahoma State,1928,N,N
9,4,0,5,Southern,,Ole Miss,1928,N,N
11,2,0,9,Pacific,,Oregon,1928,N,N
9,3,0,6,Pacific,,Oregon State,1928,N,N
9,6,0,3,FBS Independents,,Penn State,1928,N,N
9,2,0,7,FBS Independents,,Pittsburgh,1928,N,N
8,2,0,6,FBS Independents,,Princeton,1928,N,N
8,3,0,5,Western,,Purdue,1928,N,N
9,7,0,2,Southwest,,Rice,1928,N,N
9,7,0,2,Southern,,Sewanee Univ. of the South,1928,N,N
10,4,0,6,Southwest,,SMU,1928,N,N
10,2,0,8,Southern,,South Carolina,1928,N,N
12,3,0,9,Pacific,,Stanford,1928,N,N
9,4,0,5,FBS Independents,,Syracuse,1928,N,N
10,2,0,8,Southwest,,TCU,1928,N,N
10,1,0,9,Southern,,Tennessee,1928,N,N
9,2,0,7,Southwest,,Texas,1928,N,N
10,4,0,6,Southwest,,Texas A&M,1928,N,N
10,4,0,6,Southern,,Tulane,1928,N,N
9,5,0,4,Pacific,,UCLA,1928,N,N
10,0,0,10,Pacific,,USC,1928,N,N
7,1,0,6,Rocky Mountain,,Utah,1928,N,N
9,3,0,6,Rocky Mountain,,Utah State,1928,N,N
10,2,0,8,Southern,,Vanderbilt,1928,N,N
9,6,0,3,Southern,,Virginia,1928,N,N
9,2,0,7,Southern,,Virginia Tech,1928,N,N
10,4,0,6,Southern,,VMI,1928,N,N
10,7,0,3,FBS Independents,,Wake Forest,1928,N,N
11,4,0,7,Pacific,,Washington,1928,N,N
9,6,0,3,FBS Independents,,Washington & Jefferson,1928,N,N
10,8,0,2,Southern,,Washington & Lee,1928,N,N
8,6,0,2,Missouri Valley,,Washington (MO),1928,N,N
10,3,0,7,Pacific,,Washington State,1928,N,N
7,7,0,0,Rocky Mountain,,Western State,1928,N,N
10,2,0,8,FBS Independents,,West Virginia,1928,N,N
9,1,0,8,Western,,Wisconsin,1928,N,N
9,7,0,2,Rocky Mountain,,Wyoming,1928,N,N
8,4,0,4,FBS Independents,,Yale,1928,N,N
9,3,0,6,Southern,,Alabama,1929,N,N
9,2,0,7,Southwest,,Arkansas,1929,N,N
11,4,0,7,FBS Independents,,Army,1929,N,N
9,7,0,2,Southern,,Auburn,1929,N,N
11,3,0,8,Southwest,,Baylor,1929,N,N
10,5,0,5,FBS Independents,,Brown,1929,N,N
8,3,0,5,Rocky Mountain,,BYU,1929,N,N
9,2,0,7,Pacific,,California,1929,N,N
9,3,0,6,FBS Independents,,Carnegie Mellon,1929,N,N
10,3,0,7,Western,,Chicago,1929,N,N
11,3,0,8,Southern,,Clemson,1929,N,N
9,1,0,8,FBS Independents,,Colgate,1929,N,N
7,2,0,5,Rocky Mountain,,Colorado,1929,N,N
7,3,0,4,Rocky Mountain,,Colorado College,1929,N,N
7,5,0,2,Rocky Mountain,,Colorado Mines,1929,N,N
9,4,0,5,Rocky Mountain,,Colorado State,1929,N,N
9,5,0,4,FBS Independents,,Columbia,1929,N,N
8,2,0,6,FBS Independents,,Cornell,1929,N,N
8,6,0,2,Missouri Valley,,Creighton,1929,N,N
9,2,0,7,FBS Independents,,Dartmouth,1929,N,N
10,5,0,5,FBS Independents,,Davidson,1929,N,N
7,1,0,6,Rocky Mountain,,Denver,1929,N,N
9,2,0,7,FBS Independents,,Detroit Mercy,1929,N,N
9,4,0,5,Missouri Valley,,Drake,1929,N,N
10,6,0,4,Southern,,Duke,1929,N,N
10,2,0,8,Southern,,Florida,1929,N,N
9,2,0,7,FBS Independents,,Fordham,1929,N,N
9,3,0,6,FBS Independents,,Georgetown,1929,N,N
10,4,0,6,Southern,,Georgia,1929,N,N
9,6,0,3,Southern,,Georgia Tech,1929,N,N
8,2,0,6,Missouri Valley,,Grinnell,1929,N,N
8,3,0,5,FBS Independents,,Harvard,1929,N,N
9,5,0,4,Pacific,,Idaho,1929,N,N
8,1,0,7,Western,,Illinois,1929,N,N
9,6,0,3,Western,,Indiana,1929,N,N
8,3,0,5,Western,,Iowa,1929,N,N
8,7,0,1,Big 6,,Iowa State,1929,N,N
8,4,0,4,Big 6,,Kansas,1929,N,N
8,5,0,3,Big 6,,Kansas State,1929,N,N
8,2,0,6,Southern,,Kentucky,1929,N,N
9,3,0,6,Southern,,LSU,1929,N,N
8,3,0,5,FBS Independents,,Marquette,1929,N,N
10,5,0,5,Southern,,Maryland,1929,N,N
9,4,0,5,Western,,Michigan,1929,N,N
8,3,0,5,FBS Independents,,Michigan State,1929,N,N
8,2,0,6,Western,,Minnesota,1929,N,N
8,6,0,2,Southern,,Mississippi State,1929,N,N
8,3,0,5,Big 6,,Missouri,1929,N,N
9,5,0,4,Pacific,,Montana,1929,N,N
8,2,0,6,Rocky Mountain,,Montana State,1929,N,N
10,3,0,7,FBS Independents,,Navy,1929,N,N
9,8,0,1,Southern,,NC State,1929,N,N
8,3,0,5,Big 6,,Nebraska,1929,N,N
10,3,0,7,FBS Independents,,New York University,1929,N,N
10,1,0,9,Southern,,North Carolina,1929,N,N
7,3,0,4,Rocky Mountain,,Northern Colorado,1929,N,N
9,3,0,6,Western,,Northwestern,1929,N,N
9,0,0,9,FBS Independents,,Notre Dame,1929,Y,N
8,4,0,4,Western,,Ohio State,1929,N,N
8,4,0,4,Big 6,,Oklahoma,1929,N,N
9,4,0,5,Missouri Valley,,Oklahoma State,1929,N,N
9,8,0,1,Southern,,Ole Miss,1929,N,N
10,3,0,7,Pacific,,Oregon,1929,N,N
9,4,0,5,Pacific,,Oregon State,1929,N,N
9,3,0,6,FBS Independents,,Penn State,1929,N,N
10,1,0,9,FBS Independents,,Pittsburgh,1929,N,N
7,5,0,2,FBS Independents,,Princeton,1929,N,N
8,0,0,8,Western,,Purdue,1929,N,N
9,7,0,2,FBS Independents,,Regis (CO),1929,N,N
9,7,0,2,Southwest,,Rice,1929,N,N
9,6,0,3,Southern,,Sewanee Univ. of the South,1929,N,N
10,2,0,8,Southwest,,SMU,1929,N,N
11,5,0,6,Southern,,South Carolina,1929,N,N
11,2,0,9,Pacific,,Stanford,1929,N,N
9,3,0,6,FBS Independents,,Syracuse,1929,N,N
10,1,0,9,Southwest,,TCU,1929,N,N
10,0,0,10,Southern,,Tennessee,1929,N,N
9,3,0,6,Southwest,,Texas,1929,N,N
9,4,0,5,Southwest,,Texas A&M,1929,N,N
9,0,0,9,Southern,,Tulane,1929,N,N
8,4,0,4,Pacific,,UCLA,1929,N,N
12,2,0,10,Pacific,,USC,1929,N,N
7,0,0,7,Rocky Mountain,,Utah,1929,N,N
7,4,0,3,Rocky Mountain,,Utah State,1929,N,N
9,2,0,7,Southern,,Vanderbilt,1929,N,N
9,3,0,6,Southern,,Virginia,1929,N,N
9,4,0,5,Southern,,Virginia Tech,1929,N,N
10,2,0,8,Southern,,VMI,1929,N,N
12,5,0,7,FBS Independents,,Wake Forest,1929,N,N
9,7,0,2,Pacific,,Washington,1929,N,N
9,4,0,5,FBS Independents,,Washington & Jefferson,1929,N,N
9,6,0,3,Southern,,Washington & Lee,1929,N,N
8,4,0,4,Missouri Valley,,Washington (MO),1929,N,N
12,2,0,10,Pacific,,Washington State,1929,N,N
7,5,0,2,Rocky Mountain,,Western State,1929,N,N
10,4,0,6,FBS Independents,,West Virginia,1929,N,N
9,5,0,4,Western,,Wisconsin,1929,N,N
8,7,0,1,Rocky Mountain,,Wyoming,1929,N,N
8,3,0,5,FBS Independents,,Yale,1929,N,N
10,0,0,10,Southern,,Alabama,1930,Y,N
9,6,0,3,Southwest,,Arkansas,1930,N,N
11,1,0,10,FBS Independents,,Army,1930,N,N
10,7,0,3,Southern,,Auburn,1930,N,N
10,4,0,6,Southwest,,Baylor,1930,N,N
10,3,0,7,FBS Independents,,Brown,1930,N,N
9,3,0,6,FBS Independents,,Bucknell,1930,N,N
11,3,0,8,Rocky Mountain,,BYU,1930,N,N
9,5,0,4,Pacific,,California,1930,N,N
9,3,0,6,FBS Independents,,Carnegie Mellon,1930,N,N
10,1,0,9,FBS Independents,,Centenary (LA),1930,N,N
9,7,0,2,Western,,Chicago,1930,N,N
10,2,0,8,Southern,,Clemson,1930,N,N
10,1,0,9,FBS Independents,,Colgate,1930,N,N
8,1,0,7,Rocky Mountain,,Colorado,1930,N,N
8,5,0,3,Rocky Mountain,,Colorado College,1930,N,N
6,5,0,1,Rocky Mountain,,Colorado Mines,1930,N,N
9,6,0,3,Rocky Mountain,,Colorado State,1930,N,N
9,4,0,5,FBS Independents,,Columbia,1930,N,N
8,2,0,6,FBS Independents,,Cornell,1930,N,N
8,7,0,1,Missouri Valley,,Creighton,1930,N,N
9,1,0,8,FBS Independents,,Dartmouth,1930,N,N
10,4,0,6,FBS Independents,,Davidson,1930,N,N
9,4,0,5,Rocky Mountain,,Denver,1930,N,N
10,3,0,7,FBS Independents,,Detroit Mercy,1930,N,N
9,4,0,5,Missouri Valley,,Drake,1930,N,N
11,1,0,10,Southern,,Duke,1930,N,N
10,3,0,7,Southern,,Florida,1930,N,N
9,1,0,8,FBS Independents,,Fordham,1930,N,N
10,5,0,5,FBS Independents,,Georgetown,1930,N,N
10,3,0,7,Southern,,Georgia,1930,N,N
9,6,0,3,Southern,,Georgia Tech,1930,N,N
9,8,0,1,FBS Independents,,Gonzaga,1930,N,N
9,4,0,5,Missouri Valley,,Grinnell,1930,N,N
9,5,0,4,FBS Independents,,Harvard,1930,N,N
11,7,0,4,Pacific,,Idaho,1930,N,N
8,5,0,3,Western,,Illinois,1930,N,N
8,6,0,2,Western,,Indiana,1930,N,N
8,4,0,4,Western,,Iowa,1930,N,N
9,9,0,0,Big 6,,Iowa State,1930,N,N
8,2,0,6,Big 6,,Kansas,1930,N,N
8,3,0,5,Big 6,,Kansas State,1930,N,N
8,3,0,5,Southern,,Kentucky,1930,N,N
10,4,0,6,Southern,,LSU,1930,N,N
9,1,0,8,FBS Independents,,Marquette,1930,N,N
12,5,0,7,Southern,,Maryland,1930,N,N
9,1,0,8,Western,,Michigan,1930,N,N
8,2,0,6,FBS Independents,,Michigan State,1930,N,N
8,5,0,3,Western,,Minnesota,1930,N,N
9,7,0,2,Southern,,Mississippi State,1930,N,N
9,5,0,4,Big 6,,Missouri,1930,N,N
8,3,0,5,Pacific,,Montana,1930,N,N
9,3,0,6,Rocky Mountain,,Montana State,1930,N,N
11,5,0,6,FBS Independents,,Navy,1930,N,N
10,8,0,2,Southern,,NC State,1930,N,N
9,5,0,4,Big 6,,Nebraska,1930,N,N
10,3,0,7,FBS Independents,,New York University,1930,N,N
10,5,0,5,Southern,,North Carolina,1930,N,N
7,3,0,4,Rocky Mountain,,Northern Colorado,1930,N,N
8,1,0,7,Western,,Northwestern,1930,N,N
10,0,0,10,FBS Independents,,Notre Dame,1930,Y,N
8,3,0,5,Western,,Ohio State,1930,N,N
8,4,0,4,Big 6,,Oklahoma,1930,N,N
10,2,0,8,Missouri Valley,,Oklahoma State,1930,N,N
9,5,0,4,Southern,,Ole Miss,1930,N,N
9,2,0,7,Pacific,,Oregon,1930,N,N
10,3,0,7,Pacific,,Oregon State,1930,N,N
9,5,0,4,FBS Independents,,Penn State,1930,N,N
9,2,0,7,FBS Independents,,Pittsburgh,1930,N,N
7,5,0,2,FBS Independents,,Princeton,1930,N,N
8,2,0,6,Western,,Purdue,1930,N,N
9,3,0,6,FBS Independents,,Regis (CO),1930,N,N
12,4,0,8,Southwest,,Rice,1930,N,N
9,1,0,8,FBS Independents,,Saint Mary's (CA),1930,N,N
10,6,0,4,Southern,,Sewanee Univ. of the South,1930,N,N
10,3,0,7,Southwest,,SMU,1930,N,N
10,4,0,6,Southern,,South Carolina,1930,N,N
11,1,0,10,Pacific,,Stanford,1930,N,N
9,3,0,6,FBS Independents,,Syracuse,1930,N,N
12,2,0,10,Southwest,,TCU,1930,N,N
10,3,0,7,FBS Independents,,Temple,1930,N,N
10,1,0,9,Southern,,Tennessee,1930,N,N
10,2,0,8,Southwest,,Texas,1930,N,N
9,7,0,2,Southwest,,Texas A&M,1930,N,N
9,1,0,8,Southern,,Tulane,1930,N,N
8,5,0,3,Pacific,,UCLA,1930,N,N
10,2,0,8,Pacific,,USC,1930,N,N
8,0,0,8,Rocky Mountain,,Utah,1930,N,N
9,6,0,3,Rocky Mountain,,Utah State,1930,N,N
10,2,0,8,Southern,,Vanderbilt,1930,N,N
10,5,0,5,FBS Independents,,Villanova,1930,N,N
10,6,0,4,Southern,,Virginia,1930,N,N
9,3,0,6,Southern,,Virginia Tech,1930,N,N
9,6,0,3,Southern,,VMI,1930,N,N
9,4,0,5,FBS Independents,,Wake Forest,1930,N,N
9,4,0,5,Pacific,,Washington,1930,N,N
9,2,0,7,FBS Independents,,Washington & Jefferson,1930,N,N
10,7,0,3,Southern,,Washington & Lee,1930,N,N
8,3,0,5,Missouri Valley,,Washington (MO),1930,N,N
10,1,0,9,Pacific,,Washington State,1930,N,N
6,6,0,0,Rocky Mountain,,Western State,1930,N,N
10,5,0,5,FBS Independents,,West Virginia,1930,N,N
9,2,0,7,Western,,Wisconsin,1930,N,N
8,6,0,2,Rocky Mountain,,Wyoming,1930,N,N
9,4,0,5,FBS Independents,,Yale,1930,N,N
10,1,0,9,Southern,,Alabama,1931,N,N
9,5,0,4,Border,,Arizona,1931,N,N
8,2,0,6,Border,,Arizona State,1931,N,N
9,5,0,4,Southwest,,Arkansas,1931,N,N
11,2,0,9,FBS Independents,,Army,1931,N,N
9,3,0,6,Southern,,Auburn,1931,N,N
9,6,0,3,Southwest,,Baylor,1931,N,N
10,3,0,7,FBS Independents,,Brown,1931,N,N
9,0,0,9,FBS Independents,,Bucknell,1931,N,N
8,4,0,4,Rocky Mountain,,BYU,1931,N,N
10,2,0,8,Pacific,,California,1931,N,N
9,6,0,3,FBS Independents,,Carnegie Mellon,1931,N,N
10,5,0,5,FBS Independents,,Centenary (LA),1931,N,N
9,7,0,2,Western,,Chicago,1931,N,N
9,7,0,2,Southern,,Clemson,1931,N,N
9,1,0,8,FBS Independents,,Colgate,1931,N,N
8,3,0,5,Rocky Mountain,,Colorado,1931,N,N
8,4,0,4,Rocky Mountain,,Colorado College,1931,N,N
7,6,0,1,Rocky Mountain,,Colorado Mines,1931,N,N
9,4,0,5,Rocky Mountain,,Colorado State,1931,N,N
9,2,0,7,FBS Independents,,Columbia,1931,N,N
8,1,0,7,FBS Independents,,Cornell,1931,N,N
9,5,0,4,Missouri Valley,,Creighton,1931,N,N
9,3,0,6,FBS Independents,,Dartmouth,1931,N,N
10,6,0,4,FBS Independents,,Davidson,1931,N,N
10,6,0,4,Rocky Mountain,,Denver,1931,N,N
10,3,0,7,FBS Independents,,Detroit Mercy,1931,N,N
11,6,0,5,Missouri Valley,,Drake,1931,N,N
10,4,0,6,Southern,,Duke,1931,N,N
10,8,0,2,Southern,,Florida,1931,N,N
9,3,0,6,FBS Independents,,Fordham,1931,N,N
10,5,0,5,FBS Independents,,Georgetown,1931,N,N
10,2,0,8,Southern,,Georgia,1931,N,N
10,8,0,2,Southern,,Georgia Tech,1931,N,N
7,4,0,3,FBS Independents,,Gonzaga,1931,N,N
8,3,0,5,Missouri Valley,,Grinnell,1931,N,N
8,1,0,7,FBS Independents,,Harvard,1931,N,N
7,4,0,3,Pacific,,Idaho,1931,N,N
8,6,0,2,Western,,Illinois,1931,N,N
8,5,0,3,Western,,Indiana,1931,N,N
8,7,0,1,Western,,Iowa,1931,N,N
8,3,0,5,Big 6,,Iowa State,1931,N,N
10,5,0,5,Big 6,,Kansas,1931,N,N
10,2,0,8,Big 6,,Kansas State,1931,N,N
9,3,0,6,Southern,,Kentucky,1931,N,N
9,4,0,5,Southern,,LSU,1931,N,N
9,1,0,8,FBS Independents,,Marquette,1931,N,N
10,2,0,8,Southern,,Maryland,1931,N,N
10,2,0,8,Western,,Michigan,1931,N,N
9,3,0,6,FBS Independents,,Michigan State,1931,N,N
10,3,0,7,Western,,Minnesota,1931,N,N
8,6,0,2,Southern,,Mississippi State,1931,N,N
10,8,0,2,Big 6,,Missouri,1931,N,N
7,6,0,1,Pacific,,Montana,1931,N,N
7,6,0,1,Rocky Mountain,,Montana State,1931,N,N
11,6,0,5,FBS Independents,,Navy,1931,N,N
9,6,0,3,Southern,,NC State,1931,N,N
10,2,0,8,Big 6,,Nebraska,1931,N,N
7,4,0,3,Border,,New Mexico,1931,N,N
10,4,0,6,Border,,New Mexico State,1931,N,N
10,3,0,7,FBS Independents,,New York University,1931,N,N
10,3,0,7,Southern,,North Carolina,1931,N,N
8,5,0,3,Border,,Northern Arizona,1931,N,N
7,4,0,3,Rocky Mountain,,Northern Colorado,1931,N,N
9,2,0,7,Western,,Northwestern,1931,N,N
9,2,0,7,FBS Independents,,Notre Dame,1931,N,N
9,3,0,6,Western,,Ohio State,1931,N,N
12,8,0,4,Big 6,,Oklahoma,1931,N,N
11,2,0,9,Missouri Valley,,Oklahoma State,1931,N,N
9,6,0,3,Southern,,Ole Miss,1931,N,N
10,3,0,7,Pacific,,Oregon,1931,N,N
10,3,0,7,Pacific,,Oregon State,1931,N,N
10,8,0,2,FBS Independents,,Penn State,1931,N,N
9,1,0,8,FBS Independents,,Pittsburgh,1931,N,N
8,7,0,1,FBS Independents,,Princeton,1931,N,N
10,1,0,9,Western,,Purdue,1931,N,N
10,4,0,6,Southwest,,Rice,1931,N,N
10,2,0,8,FBS Independents,,Saint Mary's (CA),1931,N,N
10,3,0,7,Southern,,Sewanee Univ. of the South,1931,N,N
11,1,0,10,Southwest,,SMU,1931,N,N
10,4,0,6,Southern,,South Carolina,1931,N,N
11,3,0,8,Pacific,,Stanford,1931,N,N
9,1,0,8,FBS Independents,,Syracuse,1931,N,N
12,3,0,9,Southwest,,TCU,1931,N,N
10,2,0,8,FBS Independents,,Temple,1931,N,N
10,0,0,10,Southern,,Tennessee,1931,N,N
10,4,0,6,Southwest,,Texas,1931,N,N
10,3,0,7,Southwest,,Texas A&M,1931,N,N
12,1,0,11,Southern,,Tulane,1931,N,N
8,5,0,3,Pacific,,UCLA,1931,N,N
11,1,0,10,Pacific,,USC,1931,Y,N
9,2,0,7,Rocky Mountain,,Utah,1931,N,N
8,2,0,6,Rocky Mountain,,Utah State,1931,N,N
9,4,0,5,Southern,,Vanderbilt,1931,N,N
9,4,0,5,FBS Independents,,Villanova,1931,N,N
10,9,0,1,Southern,,Virginia,1931,N,N
9,5,0,4,Southern,,Virginia Tech,1931,N,N
10,7,0,3,Southern,,VMI,1931,N,N
8,4,0,4,FBS Independents,,Wake Forest,1931,N,N
9,4,0,5,Pacific,,Washington,1931,N,N
10,4,0,6,FBS Independents,,Washington & Jefferson,1931,N,N
10,5,0,5,Southern,,Washington & Lee,1931,N,N
9,7,0,2,Missouri Valley,,Washington (MO),1931,N,N
10,4,0,6,Pacific,,Washington State,1931,N,N
7,6,0,1,Rocky Mountain,,Western State,1931,N,N
10,6,0,4,FBS Independents,,West Virginia,1931,N,N
10,5,0,5,Western,,Wisconsin,1931,N,N
10,4,0,6,Rocky Mountain,,Wyoming,1931,N,N
8,3,0,5,FBS Independents,,Yale,1931,N,N
10,2,0,8,Southern,,Alabama,1932,N,N
9,5,0,4,Border,,Arizona,1932,N,N
8,3,0,5,Border,,Arizona State,1932,N,N
9,7,0,2,Southwest,,Arkansas,1932,N,N
10,2,0,8,FBS Independents,,Army,1932,N,N
10,1,0,9,Southern,,Auburn,1932,N,N
9,6,0,3,Southwest,,Baylor,1932,N,N
8,1,0,7,FBS Independents,,Brown,1932,N,N
9,4,0,5,FBS Independents,,Bucknell,1932,N,N
7,5,0,2,Missouri Valley,,Butler,1932,N,N
9,1,0,8,Rocky Mountain,,BYU,1932,N,N
12,5,0,7,Pacific,,California,1932,N,N
9,5,0,4,FBS Independents,,Carnegie Mellon,1932,N,N
9,1,0,8,FBS Independents,,Centenary (LA),1932,N,N
8,4,0,4,Western,,Chicago,1932,N,N
9,5,0,4,Southern,,Clemson,1932,N,N
9,0,0,9,FBS Independents,,Colgate,1932,N,N
6,4,0,2,Rocky Mountain,,Colorado,1932,N,N
7,2,0,5,Rocky Mountain,,Colorado College,1932,N,N
8,7,0,1,Rocky Mountain,,Colorado Mines,1932,N,N
8,3,0,5,Rocky Mountain,,Colorado State,1932,N,N
9,2,0,7,FBS Independents,,Columbia,1932,N,N
8,2,0,6,FBS Independents,,Cornell,1932,N,N
8,3,0,5,Missouri Valley,,Creighton,1932,N,N
8,4,0,4,FBS Independents,,Dartmouth,1932,N,N
9,5,0,4,FBS Independents,,Davidson,1932,N,N
8,4,0,4,Rocky Mountain,,Denver,1932,N,N
10,2,0,8,FBS Independents,,Detroit Mercy,1932,N,N
9,6,0,3,Missouri Valley,,Drake,1932,N,N
10,3,0,7,Southern,,Duke,1932,N,N
9,6,0,3,Southern,,Florida,1932,N,N
8,2,0,6,FBS Independents,,Fordham,1932,N,N
9,7,0,2,FBS Independents,,Georgetown,1932,N,N
9,3,0,6,FBS Independents,,George Washington,1932,N,N
9,6,0,3,Southern,,Georgia,1932,N,N
10,6,0,4,Southern,,Georgia Tech,1932,N,N
8,3,0,5,FBS Independents,,Gonzaga,1932,N,N
8,4,0,4,Missouri Valley,,Grinnell,1932,N,N
8,3,0,5,FBS Independents,,Harvard,1932,N,N
8,5,0,3,Pacific,,Idaho,1932,N,N
9,4,0,5,Western,,Illinois,1932,N,N
8,4,0,4,Western,,Indiana,1932,N,N
8,7,0,1,Western,,Iowa,1932,N,N
8,4,0,4,Big 6,,Iowa State,1932,N,N
8,3,0,5,Big 6,,Kansas,1932,N,N
8,4,0,4,Big 6,,Kansas State,1932,N,N
9,5,0,4,Southern,,Kentucky,1932,N,N
8,5,0,3,FBS Independents,,Lafayette,1932,N,N
10,4,0,6,Southern,,LSU,1932,N,N
8,3,0,5,FBS Independents,,Marquette,1932,N,N
11,6,0,5,Southern,,Maryland,1932,N,N
8,0,0,8,Western,,Michigan,1932,N,N
8,1,0,7,FBS Independents,,Michigan State,1932,N,N
8,3,0,5,Western,,Minnesota,1932,N,N
8,5,0,3,Southern,,Mississippi State,1932,N,N
9,8,0,1,Big 6,,Missouri,1932,N,N
9,7,0,2,Pacific,,Montana,1932,N,N
7,4,0,3,Rocky Mountain,,Montana State,1932,N,N
9,6,0,3,FBS Independents,,Navy,1932,N,N
9,3,0,6,Southern,,NC State,1932,N,N
9,2,0,7,Big 6,,Nebraska,1932,N,N
8,7,0,1,Border,,New Mexico,1932,N,N
10,5,0,5,Border,,New Mexico State,1932,N,N
8,3,0,5,FBS Independents,,New York University,1932,N,N
10,6,0,4,Southern,,North Carolina,1932,N,N
7,4,0,3,Border,,Northern Arizona,1932,N,N
7,2,0,5,Rocky Mountain,,Northern Colorado,1932,N,N
8,5,0,3,Western,,Northwestern,1932,N,N
9,2,0,7,FBS Independents,,Notre Dame,1932,N,N
8,3,0,5,Western,,Ohio State,1932,N,N
9,4,0,5,Big 6,,Oklahoma,1932,N,N
12,2,0,10,Missouri Valley,,Oklahoma State,1932,N,N
11,6,0,5,Southern,,Ole Miss,1932,N,N
10,4,0,6,Pacific,,Oregon,1932,N,N
10,6,0,4,Pacific,,Oregon State,1932,N,N
7,5,0,2,FBS Independents,,Penn State,1932,N,N
11,2,0,9,FBS Independents,,Pittsburgh,1932,N,N
7,5,0,2,FBS Independents,,Princeton,1932,N,N
8,0,0,8,Western,,Purdue,1932,N,N
10,3,0,7,Southwest,,Rice,1932,N,N
8,4,0,4,FBS Independents,,Richmond,1932,N,N
7,2,0,5,FBS Independents,,Saint Louis,1932,N,N
9,2,0,7,FBS Independents,,Saint Mary's (CA),1932,N,N
8,6,0,2,FBS Independents,,San Francisco,1932,N,N
9,3,0,6,FBS Independents,,Santa Clara,1932,N,N
10,8,0,2,Southern,,Sewanee Univ. of the South,1932,N,N
12,9,0,3,Southwest,,SMU,1932,N,N
11,4,0,7,Southern,,South Carolina,1932,N,N
11,4,0,7,Pacific,,Stanford,1932,N,N
9,4,0,5,FBS Independents,,Syracuse,1932,N,N
11,0,0,11,Southwest,,TCU,1932,N,N
8,1,0,7,FBS Independents,,Temple,1932,N,N
10,0,0,10,Southern,,Tennessee,1932,N,N
10,2,0,8,Southwest,,Texas,1932,N,N
10,4,0,6,Southwest,,Texas A&M,1932,N,N
12,2,0,10,Border,,Texas Tech,1932,N,N
9,5,0,4,FBS Independents,,The Citadel,1932,N,N
9,3,0,6,Southern,,Tulane,1932,N,N
10,4,0,6,Pacific,,UCLA,1932,N,N
10,0,0,10,Pacific,,USC,1932,Y,N
8,2,0,6,Rocky Mountain,,Utah,1932,N,N
8,4,0,4,Rocky Mountain,,Utah State,1932,N,N
9,2,0,7,Southern,,Vanderbilt,1932,N,N
9,2,0,7,FBS Independents,,Villanova,1932,N,N
9,4,0,5,Southern,,Virginia,1932,N,N
9,1,0,8,Southern,,Virginia Tech,1932,N,N
10,8,0,2,Southern,,VMI,1932,N,N
8,3,0,5,FBS Independents,,Wake Forest,1932,N,N
10,3,0,7,Pacific,,Washington,1932,N,N
9,3,0,6,FBS Independents,,Washington & Jefferson,1932,N,N
10,9,0,1,Southern,,Washington & Lee,1932,N,N
8,4,0,4,Missouri Valley,,Washington (MO),1932,N,N
9,1,0,8,Pacific,,Washington State,1932,N,N
6,5,0,1,Rocky Mountain,,Western State,1932,N,N
10,5,0,5,FBS Independents,,West Virginia,1932,N,N
12,4,0,8,FBS Independents,,William & Mary,1932,N,N
8,1,0,7,Western,,Wisconsin,1932,N,N
9,7,0,2,Rocky Mountain,,Wyoming,1932,N,N
7,4,0,3,FBS Independents,,Yale,1932,N,N
9,2,0,7,SEC,,Alabama,1933,N,N
8,3,0,5,Border,,Arizona,1933,N,N
8,5,0,3,Border,,Arizona State,1933,N,N
11,4,0,7,Southwest,,Arkansas,1933,N,N
10,1,0,9,FBS Independents,,Army,1933,N,N
10,5,0,5,SEC,,Auburn,1933,N,N
10,4,0,6,Southwest,,Baylor,1933,N,N
8,5,0,3,FBS Independents,,Brown,1933,N,N
9,2,0,7,FBS Independents,,Bucknell,1933,N,N
8,6,0,2,Missouri Valley,,Butler,1933,N,N
9,4,0,5,Rocky Mountain,,BYU,1933,N,N
11,4,0,7,Pacific,,California,1933,N,N
9,3,0,6,FBS Independents,,Carnegie Mellon,1933,N,N
12,1,0,11,FBS Independents,,Centenary (LA),1933,N,N
8,5,0,3,Western,,Chicago,1933,N,N
11,7,0,4,Southern,,Clemson,1933,N,N
8,2,0,6,FBS Independents,,Colgate,1933,N,N
9,2,0,7,Rocky Mountain,,Colorado,1933,N,N
8,6,0,2,Rocky Mountain,,Colorado College,1933,N,N
6,5,0,1,Rocky Mountain,,Colorado Mines,1933,N,N
7,1,0,6,Rocky Mountain,,Colorado State,1933,N,N
9,1,0,8,FBS Independents,,Columbia,1933,N,N
7,3,0,4,FBS Independents,,Cornell,1933,N,N
8,5,0,3,Missouri Valley,,Creighton,1933,N,N
9,4,0,5,FBS Independents,,Dartmouth,1933,N,N
9,2,0,7,FBS Independents,,Davidson,1933,N,N
9,4,0,5,Rocky Mountain,,Denver,1933,N,N
8,1,0,7,FBS Independents,,Detroit Mercy,1933,N,N
10,4,0,6,Missouri Valley,,Drake,1933,N,N
10,1,0,9,Southern,,Duke,1933,N,N
11,1,0,10,FBS Independents,,Duquesne,1933,N,N
9,3,0,6,SEC,,Florida,1933,N,N
8,2,0,6,FBS Independents,,Fordham,1933,N,N
9,2,0,7,FBS Independents,,Furman,1933,N,N
8,7,0,1,FBS Independents,,Georgetown,1933,N,N
9,4,0,5,FBS Independents,,George Washington,1933,N,N
10,2,0,8,SEC,,Georgia,1933,N,N
10,5,0,5,SEC,,Georgia Tech,1933,N,N
9,6,0,3,FBS Independents,,Gonzaga,1933,N,N
9,8,0,1,Missouri Valley,,Grinnell,1933,N,N
8,3,0,5,FBS Independents,,Harvard,1933,N,N
8,4,0,4,Pacific,,Idaho,1933,N,N
8,3,0,5,Western,,Illinois,1933,N,N
8,5,0,3,Western,,Indiana,1933,N,N
8,3,0,5,Western,,Iowa,1933,N,N
9,5,0,4,Big 6,,Iowa State,1933,N,N
10,4,0,6,Big 6,,Kansas,1933,N,N
9,2,0,7,Big 6,,Kansas State,1933,N,N
10,5,0,5,SEC,,Kentucky,1933,N,N
9,5,0,4,FBS Independents,,Lafayette,1933,N,N
10,3,0,7,FBS Independents,,Loyola Marymount,1933,N,N
10,2,0,8,SEC,,LSU,1933,N,N
8,4,0,4,FBS Independents,,Marquette,1933,N,N
10,7,0,3,Southern,,Maryland,1933,N,N
9,3,0,6,FBS Independents,,Mercer,1933,N,N
8,1,0,7,Western,,Michigan,1933,Y,N
8,4,0,4,FBS Independents,,Michigan State,1933,N,N
8,2,0,6,Western,,Minnesota,1933,N,N
10,6,0,4,SEC,,Mississippi State,1933,N,N
9,8,0,1,Big 6,,Missouri,1933,N,N
7,4,0,3,Pacific,,Montana,1933,N,N
7,5,0,2,Rocky Mountain,,Montana State,1933,N,N
9,4,0,5,FBS Independents,,Navy,1933,N,N
9,8,0,1,Southern,,NC State,1933,N,N
9,1,0,8,Big 6,,Nebraska,1933,N,N
8,4,0,4,Border,,New Mexico,1933,N,N
8,6,0,2,Border,,New Mexico State,1933,N,N
7,5,0,2,FBS Independents,,New York University,1933,N,N
9,5,0,4,Southern,,North Carolina,1933,N,N
6,1,0,5,Border,,Northern Arizona,1933,N,N
7,3,0,4,Rocky Mountain,,Northern Colorado,1933,N,N
8,7,0,1,Western,,Northwestern,1933,N,N
9,6,0,3,FBS Independents,,Notre Dame,1933,N,N
8,1,0,7,Western,,Ohio State,1933,N,N
9,5,0,4,Big 6,,Oklahoma,1933,N,N
9,2,0,7,Missouri Valley,,Oklahoma State,1933,N,N
11,3,0,8,SEC,,Ole Miss,1933,N,N
10,1,0,9,Pacific,,Oregon,1933,N,N
10,4,0,6,Pacific,,Oregon State,1933,N,N
7,3,0,4,FBS Independents,,Penn State,1933,N,N
9,1,0,8,FBS Independents,,Pittsburgh,1933,N,N
9,0,0,9,FBS Independents,,Princeton,1933,N,N
8,1,0,7,Western,,Purdue,1933,N,N
11,8,0,3,Southwest,,Rice,1933,N,N
9,4,0,5,FBS Independents,,Richmond,1933,N,N
9,3,0,6,FBS Independents,,Saint Louis,1933,N,N
10,3,0,7,FBS Independents,,Saint Mary's (CA),1933,N,N
8,6,0,2,FBS Independents,,San Francisco,1933,N,N
9,3,0,6,FBS Independents,,Santa Clara,1933,N,N
9,6,0,3,SEC,,Sewanee Univ. of the South,1933,N,N
12,8,0,4,Southwest,,SMU,1933,N,N
10,4,0,6,Southern,,South Carolina,1933,N,N
11,2,0,9,Pacific,,Stanford,1933,N,N
8,4,0,4,FBS Independents,,Syracuse,1933,N,N
12,2,0,10,Southwest,,TCU,1933,N,N
8,3,0,5,FBS Independents,,Temple,1933,N,N
10,3,0,7,SEC,,Tennessee,1933,N,N
11,6,0,5,Southwest,,Texas,1933,N,N
10,4,0,6,Southwest,,Texas A&M,1933,N,N
9,1,0,8,Border,,Texas Tech,1933,N,N
9,5,0,4,FBS Independents,,The Citadel,1933,N,N
10,4,0,6,SEC,,Tulane,1933,N,N
7,1,0,6,FBS Independents,,Tulsa,1933,N,N
11,5,0,6,Pacific,,UCLA,1933,N,N
12,1,0,11,Pacific,,USC,1933,N,N
8,3,0,5,Rocky Mountain,,Utah,1933,N,N
8,4,0,4,Rocky Mountain,,Utah State,1933,N,N
10,4,0,6,SEC,,Vanderbilt,1933,N,N
10,3,0,7,FBS Independents,,Villanova,1933,N,N
10,8,0,2,Southern,,Virginia,1933,N,N
10,4,0,6,Southern,,Virginia Tech,1933,N,N
10,8,0,2,Southern,,VMI,1933,N,N
6,5,0,1,FBS Independents,,Wake Forest,1933,N,N
9,4,0,5,Pacific,,Washington,1933,N,N
10,8,0,2,FBS Independents,,Washington & Jefferson,1933,N,N
10,5,0,5,Southern,,Washington & Lee,1933,N,N
9,5,0,4,Missouri Valley,,Washington (MO),1933,N,N
9,3,0,6,Pacific,,Washington State,1933,N,N
5,5,0,0,Rocky Mountain,,Western State,1933,N,N
11,7,0,4,FBS Independents,,West Virginia,1933,N,N
11,5,0,6,FBS Independents,,William & Mary,1933,N,N
8,5,0,3,Western,,Wisconsin,1933,N,N
9,6,0,3,FBS Independents,,Wofford,1933,N,N
9,6,0,3,Rocky Mountain,,Wyoming,1933,N,N
8,4,0,4,FBS Independents,,Yale,1933,N,N
10,0,0,10,SEC,,Alabama,1934,N,N
10,3,0,7,Border,,Arizona,1934,N,N
8,3,0,5,Border,,Arizona State,1934,N,N
10,4,0,6,Southwest,,Arkansas,1934,N,N
10,3,0,7,FBS Independents,,Army,1934,N,N
10,8,0,2,SEC,,Auburn,1934,N,N
10,7,0,3,Southwest,,Baylor,1934,N,N
9,6,0,3,FBS Independents,,Brown,1934,N,N
11,3,0,8,FBS Independents,,Bucknell,1934,N,N
9,5,0,4,Rocky Mountain,,BYU,1934,N,N
12,6,0,6,Pacific,,California,1934,N,N
9,5,0,4,FBS Independents,,Carnegie Mellon,1934,N,N
12,2,0,10,FBS Independents,,Centenary (LA),1934,N,N
8,4,0,4,Western,,Chicago,1934,N,N
9,4,0,5,Southern,,Clemson,1934,N,N
8,1,0,7,FBS Independents,,Colgate,1934,N,N
9,2,0,7,Rocky Mountain,,Colorado,1934,N,N
8,7,0,1,Rocky Mountain,,Colorado College,1934,N,N
7,6,0,1,Rocky Mountain,,Colorado Mines,1934,N,N
9,2,0,7,Rocky Mountain,,Colorado State,1934,N,N
8,1,0,7,FBS Independents,,Columbia,1934,N,N
7,5,0,2,FBS Independents,,Cornell,1934,N,N
9,7,0,2,Missouri Valley,,Creighton,1934,N,N
9,3,0,6,FBS Independents,,Dartmouth,1934,N,N
9,4,0,5,FBS Independents,,Davidson,1934,N,N
11,5,0,6,Rocky Mountain,,Denver,1934,N,N
9,3,0,6,FBS Independents,,Detroit Mercy,1934,N,N
10,7,0,3,Missouri Valley,,Drake,1934,N,N
9,2,0,7,Southern,,Duke,1934,N,N
10,2,0,8,FBS Independents,,Duquesne,1934,N,N
10,4,0,6,SEC,,Florida,1934,N,N
8,3,0,5,FBS Independents,,Fordham,1934,N,N
9,4,0,5,FBS Independents,,Furman,1934,N,N
8,3,0,5,FBS Independents,,Georgetown,1934,N,N
10,4,0,6,FBS Independents,,George Washington,1934,N,N
10,3,0,7,SEC,,Georgia,1934,N,N
10,9,0,1,SEC,,Georgia Tech,1934,N,N
11,2,0,9,FBS Independents,,Gonzaga,1934,N,N
9,7,0,2,Missouri Valley,,Grinnell,1934,N,N
8,5,0,3,FBS Independents,,Harvard,1934,N,N
8,5,0,3,Pacific,,Idaho,1934,N,N
8,1,0,7,Western,,Illinois,1934,N,N
8,4,0,4,Western,,Indiana,1934,N,N
8,5,0,3,Western,,Iowa,1934,N,N
9,4,0,5,Big 6,,Iowa State,1934,N,N
10,6,0,4,Big 6,,Kansas,1934,N,N
10,2,0,8,Big 6,,Kansas State,1934,N,N
10,5,0,5,SEC,,Kentucky,1934,N,N
9,5,0,4,FBS Independents,,Loyola (LA),1934,N,N
10,2,0,8,FBS Independents,,Loyola Marymount,1934,N,N
11,3,0,8,SEC,,LSU,1934,N,N
9,5,0,4,FBS Independents,,Marquette,1934,N,N
10,3,0,7,Southern,,Maryland,1934,N,N
10,6,0,4,FBS Independents,,Mercer,1934,N,N
8,7,0,1,Western,,Michigan,1934,N,N
9,1,0,8,FBS Independents,,Michigan State,1934,N,N
8,0,0,8,Western,,Minnesota,1934,Y,N
10,6,0,4,SEC,,Mississippi State,1934,N,N
9,8,0,1,Big 6,,Missouri,1934,N,N
8,5,0,3,Pacific,,Montana,1934,N,N
7,5,0,2,Rocky Mountain,,Montana State,1934,N,N
9,1,0,8,FBS Independents,,Navy,1934,N,N
9,6,0,3,Southern,,NC State,1934,N,N
9,3,0,6,Big 6,,Nebraska,1934,N,N
9,1,0,8,Border,,New Mexico,1934,N,N
8,3,0,5,Border,,New Mexico State,1934,N,N
8,5,0,3,FBS Independents,,New York University,1934,N,N
9,2,0,7,Southern,,North Carolina,1934,N,N
7,5,0,2,Border,,Northern Arizona,1934,N,N
7,1,0,6,Rocky Mountain,,Northern Colorado,1934,N,N
8,5,0,3,Western,,Northwestern,1934,N,N
9,3,0,6,FBS Independents,,Notre Dame,1934,N,N
8,1,0,7,Western,,Ohio State,1934,N,N
9,4,0,5,Big 6,,Oklahoma,1934,N,N
10,6,0,4,Missouri Valley,,Oklahoma State,1934,N,N
10,5,0,5,SEC,,Ole Miss,1934,N,N
10,4,0,6,Pacific,,Oregon,1934,N,N
11,7,0,4,Pacific,,Oregon State,1934,N,N
8,4,0,4,FBS Independents,,Penn State,1934,N,N
9,1,0,8,FBS Independents,,Pittsburgh,1934,N,N
8,1,0,7,FBS Independents,,Princeton,1934,N,N
8,3,0,5,Western,,Purdue,1934,N,N
11,2,0,9,Southwest,,Rice,1934,N,N
9,1,0,8,FBS Independents,,Richmond,1934,N,N
8,4,0,4,FBS Independents,,Saint Louis,1934,N,N
9,2,0,7,FBS Independents,,Saint Mary's (CA),1934,N,N
7,4,0,3,FBS Independents,,San Francisco,1934,N,N
10,2,0,8,FBS Independents,,Santa Clara,1934,N,N
9,7,0,2,SEC,,Sewanee Univ. of the South,1934,N,N
12,2,0,10,Southwest,,SMU,1934,N,N
9,4,0,5,Southern,,South Carolina,1934,N,N
11,2,0,9,Pacific,,Stanford,1934,N,N
8,2,0,6,FBS Independents,,Syracuse,1934,N,N
12,4,0,8,Southwest,,TCU,1934,N,N
10,3,0,7,FBS Independents,,Temple,1934,N,N
10,2,0,8,SEC,,Tennessee,1934,N,N
10,3,0,7,Southwest,,Texas,1934,N,N
11,9,0,2,Southwest,,Texas A&M,1934,N,N
10,3,0,7,Border,,Texas Tech,1934,N,N
9,6,0,3,FBS Independents,,The Citadel,1934,N,N
11,1,0,10,SEC,,Tulane,1934,N,N
8,3,0,5,FBS Independents,,Tulsa,1934,N,N
10,3,0,7,Pacific,,UCLA,1934,N,N
11,7,0,4,Pacific,,USC,1934,N,N
8,3,0,5,Rocky Mountain,,Utah,1934,N,N
7,2,0,5,Rocky Mountain,,Utah State,1934,N,N
9,3,0,6,SEC,,Vanderbilt,1934,N,N
9,6,0,3,FBS Independents,,Villanova,1934,N,N
9,6,0,3,Southern,,Virginia,1934,N,N
10,5,0,5,Southern,,Virginia Tech,1934,N,N
9,8,0,1,Southern,,VMI,1934,N,N
10,7,0,3,FBS Independents,,Wake Forest,1934,N,N
8,2,0,6,Pacific,,Washington,1934,N,N
9,5,0,4,FBS Independents,,Washington & Jefferson,1934,N,N
10,3,0,7,Southern,,Washington & Lee,1934,N,N
10,3,0,7,Missouri Valley,,Washington (MO),1934,N,N
8,3,0,5,Pacific,,Washington State,1934,N,N
7,5,0,2,Rocky Mountain,,Western State,1934,N,N
10,4,0,6,FBS Independents,,West Virginia,1934,N,N
8,6,0,2,FBS Independents,,William & Mary,1934,N,N
8,4,0,4,Western,,Wisconsin,1934,N,N
8,5,0,3,Rocky Mountain,,Wyoming,1934,N,N
8,3,0,5,FBS Independents,,Yale,1934,N,N
9,3,0,6,SEC,,Alabama,1935,N,N
9,2,0,7,Border,,Arizona,1935,N,N
8,6,0,2,Border,,Arizona State,1935,N,N
10,5,0,5,Southwest,,Arkansas,1935,N,N
9,3,0,6,FBS Independents,,Army,1935,N,N
10,2,0,8,SEC,,Auburn,1935,N,N
11,3,0,8,Southwest,,Baylor,1935,N,N
9,8,0,1,FBS Independents,,Brown,1935,N,N
9,3,0,6,FBS Independents,,Bucknell,1935,N,N
8,4,0,4,Rocky Mountain,,BYU,1935,N,N
10,1,0,9,Pacific,,California,1935,N,N
8,5,0,3,FBS Independents,,Carnegie Mellon,1935,N,N
11,5,0,6,FBS Independents,,Centenary (LA),1935,N,N
9,7,0,2,FBS Independents,,Centre,1935,N,N
8,4,0,4,Western,,Chicago,1935,N,N
9,3,0,6,Southern,,Clemson,1935,N,N
8,3,0,5,FBS Independents,,Colgate,1935,N,N
9,4,0,5,Rocky Mountain,,Colorado,1935,N,N
8,4,0,4,Rocky Mountain,,Colorado College,1935,N,N
7,6,0,1,Rocky Mountain,,Colorado Mines,1935,N,N
8,4,0,4,Rocky Mountain,,Colorado State,1935,N,N
9,4,0,5,FBS Independents,,Columbia,1935,N,N
7,7,0,0,FBS Independents,,Cornell,1935,N,N
9,6,0,3,Missouri Valley,,Creighton,1935,N,N
10,2,0,8,FBS Independents,,Dartmouth,1935,N,N
9,3,0,6,FBS Independents,,Davidson,1935,N,N
9,3,0,6,Rocky Mountain,,Denver,1935,N,N
9,3,0,6,FBS Independents,,Detroit Mercy,1935,N,N
10,5,0,5,Missouri Valley,,Drake,1935,N,N
10,2,0,8,Southern,,Duke,1935,N,N
9,3,0,6,FBS Independents,,Duquesne,1935,N,N
10,7,0,3,SEC,,Florida,1935,N,N
9,3,0,6,FBS Independents,,Fordham,1935,N,N
9,1,0,8,FBS Independents,,Furman,1935,N,N
8,4,0,4,FBS Independents,,Georgetown,1935,N,N
9,3,0,6,FBS Independents,,George Washington,1935,N,N
10,4,0,6,SEC,,Georgia,1935,N,N
10,5,0,5,SEC,,Georgia Tech,1935,N,N
10,4,0,6,FBS Independents,,Gonzaga,1935,N,N
9,5,0,4,Missouri Valley,,Grinnell,1935,N,N
8,5,0,3,FBS Independents,,Harvard,1935,N,N
9,7,0,2,Pacific,,Idaho,1935,N,N
8,5,0,3,Western,,Illinois,1935,N,N
8,3,0,5,Western,,Indiana,1935,N,N
8,3,0,5,Western,,Iowa,1935,N,N
9,6,0,3,Big 6,,Iowa State,1935,N,N
9,5,0,4,Big 6,,Kansas,1935,N,N
9,5,0,4,Big 6,,Kansas State,1935,N,N
9,4,0,5,SEC,,Kentucky,1935,N,N
9,7,0,2,FBS Independents,,Loyola (LA),1935,N,N
11,5,0,6,FBS Independents,,Loyola Marymount,1935,N,N
11,2,0,9,SEC,,LSU,1935,N,N
8,1,0,7,FBS Independents,,Marquette,1935,N,N
11,4,0,7,Southern,,Maryland,1935,N,N
9,5,0,4,FBS Independents,,Mercer,1935,N,N
8,4,0,4,Western,,Michigan,1935,N,N
8,2,0,6,FBS Independents,,Michigan State,1935,N,N
8,0,0,8,Western,,Minnesota,1935,Y,N
11,3,0,8,SEC,,Mississippi State,1935,N,N
9,4,0,5,Big 6,,Missouri,1935,N,N
8,7,0,1,Pacific,,Montana,1935,N,N
9,6,0,3,Rocky Mountain,,Montana State,1935,N,N
9,4,0,5,FBS Independents,,Navy,1935,N,N
10,4,0,6,Southern,,NC State,1935,N,N
9,2,0,7,Big 6,,Nebraska,1935,N,N
10,4,0,6,Border,,New Mexico,1935,N,N
10,2,0,8,Border,,New Mexico State,1935,N,N
8,1,0,7,FBS Independents,,New York University,1935,N,N
9,1,0,8,Southern,,North Carolina,1935,N,N
9,5,0,4,Border,,Northern Arizona,1935,N,N
7,3,0,4,Rocky Mountain,,Northern Colorado,1935,N,N
8,4,0,4,Western,,Northwestern,1935,N,N
9,1,0,8,FBS Independents,,Notre Dame,1935,N,N
8,1,0,7,Western,,Ohio State,1935,N,N
9,3,0,6,Big 6,,Oklahoma,1935,N,N
10,7,0,3,Missouri Valley,,Oklahoma State,1935,N,N
12,3,0,9,SEC,,Ole Miss,1935,N,N
9,3,0,6,Pacific,,Oregon,1935,N,N
11,4,0,7,Pacific,,Oregon State,1935,N,N
8,4,0,4,FBS Independents,,Penn State,1935,N,N
10,2,0,8,FBS Independents,,Pittsburgh,1935,N,N
9,7,0,2,FBS Independents,,Presbyterian College,1935,N,N
9,0,0,9,FBS Independents,,Princeton,1935,N,N
8,4,0,4,Western,,Purdue,1935,N,N
11,3,0,8,Southwest,,Rice,1935,N,N
9,6,0,3,FBS Independents,,Richmond,1935,N,N
11,6,0,5,FBS Independents,,Saint Louis,1935,N,N
9,3,0,6,FBS Independents,,Saint Mary's (CA),1935,N,N
8,3,0,5,FBS Independents,,San Francisco,1935,N,N
9,6,0,3,FBS Independents,,Santa Clara,1935,N,N
9,7,0,2,SEC,,Sewanee Univ. of the South,1935,N,N
13,1,0,12,Southwest,,SMU,1935,N,N
10,7,0,3,Southern,,South Carolina,1935,N,N
9,1,0,8,Pacific,,Stanford,1935,N,N
8,1,0,7,FBS Independents,,Syracuse,1935,N,N
13,1,0,12,Southwest,,TCU,1935,N,N
10,3,0,7,FBS Independents,,Temple,1935,N,N
9,5,0,4,SEC,,Tennessee,1935,N,N
10,6,0,4,Southwest,,Texas,1935,N,N
10,7,0,3,Southwest,,Texas A&M,1935,N,N
10,3,0,7,Border,,Texas Tech,1935,N,N
8,4,0,4,FBS Independents,,The Citadel,1935,N,N
10,4,0,6,SEC,,Tulane,1935,N,N
10,7,0,3,Missouri Valley,,Tulsa,1935,N,N
10,2,0,8,Pacific,,UCLA,1935,N,N
12,7,0,5,Pacific,,USC,1935,N,N
8,4,0,4,Rocky Mountain,,Utah,1935,N,N
8,2,0,6,Rocky Mountain,,Utah State,1935,N,N
9,8,0,1,Border,,UTEP,1935,N,N
10,3,0,7,SEC,,Vanderbilt,1935,N,N
9,2,0,7,FBS Independents,,Villanova,1935,N,N
10,8,0,2,Southern,,Virginia,1935,N,N
9,4,0,5,Southern,,Virginia Tech,1935,N,N
10,7,0,3,Southern,,VMI,1935,N,N
9,7,0,2,FBS Independents,,Wake Forest,1935,N,N
10,6,0,4,Missouri Valley,,Washburn,1935,N,N
8,3,0,5,Pacific,,Washington,1935,N,N
8,4,0,4,Southern,,Washington & Lee,1935,N,N
10,4,0,6,Missouri Valley,,Washington (MO),1935,N,N
9,3,0,6,Pacific,,Washington State,1935,N,N
7,6,0,1,Rocky Mountain,,Western State,1935,N,N
9,5,0,4,FBS Independents,,West Virginia,1935,N,N
10,5,0,5,FBS Independents,,William & Mary,1935,N,N
8,7,0,1,Western,,Wisconsin,1935,N,N
8,4,0,4,Rocky Mountain,,Wyoming,1935,N,N
9,3,0,6,FBS Independents,,Xavier,1935,N,N
9,3,0,6,FBS Independents,,Yale,1935,N,N
9,1,0,8,SEC,,Alabama,1936,N,N
10,4,0,6,Border,,Arizona,1936,N,N
9,5,0,4,Border,,Arizona State,1936,N,N
10,3,0,7,Southwest,,Arkansas,1936,N,N
9,3,0,6,FBS Independents,,Army,1936,N,N
11,3,0,8,SEC,,Auburn,1936,N,N
10,4,0,6,Southwest,,Baylor,1936,N,N
10,7,0,3,FBS Independents,,Brown,1936,N,N
9,4,0,5,FBS Independents,,Bucknell,1936,N,N
9,5,0,4,Rocky Mountain,,BYU,1936,N,N
11,5,0,6,Pacific,,California,1936,N,N
8,6,0,2,FBS Independents,,Carnegie Mellon,1936,N,N
12,4,0,8,FBS Independents,,Centenary (LA),1936,N,N
8,6,0,2,Western,,Chicago,1936,N,N
10,5,0,5,Southern,,Clemson,1936,N,N
9,3,0,6,FBS Independents,,Colgate,1936,N,N
7,3,0,4,Rocky Mountain,,Colorado,1936,N,N
8,5,0,3,Rocky Mountain,,Colorado College,1936,N,N
8,6,0,2,Rocky Mountain,,Colorado Mines,1936,N,N
9,4,0,5,Rocky Mountain,,Colorado State,1936,N,N
8,3,0,5,FBS Independents,,Columbia,1936,N,N
8,5,0,3,FBS Independents,,Cornell,1936,N,N
8,4,0,4,Missouri Valley,,Creighton,1936,N,N
9,1,0,8,FBS Independents,,Dartmouth,1936,N,N
9,4,0,5,Southern,,Davidson,1936,N,N
9,2,0,7,Rocky Mountain,,Denver,1936,N,N
10,3,0,7,FBS Independents,,Detroit Mercy,1936,N,N
10,4,0,6,Missouri Valley,,Drake,1936,N,N
10,1,0,9,Southern,,Duke,1936,N,N
10,2,0,8,FBS Independents,,Duquesne,1936,N,N
9,5,0,4,FBS Independents,,Erskine,1936,N,N
10,6,0,4,SEC,,Florida,1936,N,N
8,3,0,5,FBS Independents,,Fordham,1936,N,N
9,2,0,7,Southern,,Furman,1936,N,N
9,2,0,7,FBS Independents,,Georgetown,1936,N,N
9,2,0,7,FBS Independents,,George Washington,1936,N,N
10,4,0,6,SEC,,Georgia,1936,N,N
11,5,0,6,SEC,,Georgia Tech,1936,N,N
8,3,0,5,FBS Independents,,Gonzaga,1936,N,N
9,7,0,2,Missouri Valley,,Grinnell,1936,N,N
8,5,0,3,FBS Independents,,Harvard,1936,N,N
10,3,0,7,FBS Independents,,Holy Cross,1936,N,N
10,7,0,3,Pacific,,Idaho,1936,N,N
8,3,0,5,Western,,Illinois,1936,N,N
8,2,0,6,Western,,Indiana,1936,N,N
8,5,0,3,Western,,Iowa,1936,N,N
8,5,0,3,Big 6,,Iowa State,1936,N,N
8,7,0,1,Big 6,,Kansas,1936,N,N
9,4,0,5,Big 6,,Kansas State,1936,N,N
10,4,0,6,SEC,,Kentucky,1936,N,N
10,6,0,4,FBS Independents,,Loyola (LA),1936,N,N
9,3,0,6,FBS Independents,,Loyola Marymount,1936,N,N
11,1,0,10,SEC,,LSU,1936,N,N
10,4,0,6,FBS Independents,,Manhattan,1936,N,N
9,2,0,7,FBS Independents,,Marquette,1936,N,N
11,5,0,6,Southern,,Maryland,1936,N,N
10,7,0,3,FBS Independents,,Mercer,1936,N,N
10,3,0,7,FBS Independents,,Miami,1936,N,N
8,7,0,1,Western,,Michigan,1936,N,N
9,1,0,8,FBS Independents,,Michigan State,1936,N,N
8,1,0,7,Western,,Minnesota,1936,Y,N
11,3,0,8,SEC,,Mississippi State,1936,N,N
9,2,0,7,Big 6,,Missouri,1936,N,N
9,3,0,6,Pacific,,Montana,1936,N,N
8,5,0,3,Rocky Mountain,,Montana State,1936,N,N
9,3,0,6,FBS Independents,,Navy,1936,N,N
10,7,0,3,Southern,,NC State,1936,N,N
9,2,0,7,Big 6,,Nebraska,1936,N,N
9,7,0,2,Border,,New Mexico,1936,N,N
11,5,0,6,Border,,New Mexico State,1936,N,N
9,4,0,5,FBS Independents,,New York University,1936,N,N
10,2,0,8,Southern,,North Carolina,1936,N,N
8,5,0,3,Border,,Northern Arizona,1936,N,N
9,4,0,5,Rocky Mountain,,Northern Colorado,1936,N,N
8,1,0,7,Western,,Northwestern,1936,N,N
9,2,0,7,FBS Independents,,Notre Dame,1936,N,N
8,3,0,5,Western,,Ohio State,1936,N,N
9,5,0,4,Big 6,,Oklahoma,1936,N,N
10,9,0,1,Missouri Valley,,Oklahoma State,1936,N,N
12,6,0,6,SEC,,Ole Miss,1936,N,N
9,6,0,3,Pacific,,Oregon,1936,N,N
10,6,0,4,Pacific,,Oregon State,1936,N,N
8,5,0,3,FBS Independents,,Penn State,1936,N,N
10,1,0,9,FBS Independents,,Pittsburgh,1936,N,N
9,6,0,3,FBS Independents,,Presbyterian College,1936,N,N
8,3,0,5,FBS Independents,,Princeton,1936,N,N
8,3,0,5,Western,,Purdue,1936,N,N
12,7,0,5,Southwest,,Rice,1936,N,N
10,6,0,4,Southern,,Richmond,1936,N,N
10,5,0,5,FBS Independents,,Saint Louis,1936,N,N
10,4,0,6,FBS Independents,,Saint Mary's (CA),1936,N,N
10,4,0,6,FBS Independents,,San Francisco,1936,N,N
9,1,0,8,FBS Independents,,Santa Clara,1936,N,N
7,7,0,0,SEC,,Sewanee Univ. of the South,1936,N,N
10,5,0,5,Southwest,,SMU,1936,N,N
12,7,0,5,Southern,,South Carolina,1936,N,N
9,7,0,2,Pacific,,Stanford,1936,N,N
8,7,0,1,FBS Independents,,Syracuse,1936,N,N
13,3,0,10,Southwest,,TCU,1936,N,N
11,5,0,6,FBS Independents,,Temple,1936,N,N
10,2,0,8,SEC,,Tennessee,1936,N,N
9,7,0,2,Southwest,,Texas,1936,N,N
12,3,0,9,Southwest,,Texas A&M,1936,N,N
10,4,0,6,Border,,Texas Tech,1936,N,N
10,6,0,4,Southern,,The Citadel,1936,N,N
10,4,0,6,SEC,,Tulane,1936,N,N
9,3,0,6,Missouri Valley,,Tulsa,1936,N,N
10,3,0,7,Pacific,,UCLA,1936,N,N
9,5,0,4,Pacific,,USC,1936,N,N
9,3,0,6,Rocky Mountain,,Utah,1936,N,N
8,0,0,8,Rocky Mountain,,Utah State,1936,N,N
9,3,0,6,Border,,UTEP,1936,N,N
9,6,0,3,SEC,,Vanderbilt,1936,N,N
10,2,0,8,FBS Independents,,Villanova,1936,N,N
9,7,0,2,FBS Independents,,Virginia,1936,N,N
10,5,0,5,Southern,,Virginia Tech,1936,N,N
10,4,0,6,Southern,,VMI,1936,N,N
9,4,0,5,Southern,,Wake Forest,1936,N,N
9,6,0,3,Missouri Valley,,Washburn,1936,N,N
10,2,0,8,Pacific,,Washington,1936,N,N
9,5,0,4,Southern,,Washington & Lee,1936,N,N
10,7,0,3,Missouri Valley,,Washington (MO),1936,N,N
10,3,0,7,Pacific,,Washington State,1936,N,N
7,6,0,1,Rocky Mountain,,Western State,1936,N,N
10,4,0,6,FBS Independents,,West Virginia,1936,N,N
9,8,0,1,Southern,,William & Mary,1936,N,N
8,6,0,2,Western,,Wisconsin,1936,N,N
9,8,0,1,FBS Independents,,Wofford,1936,N,N
8,6,0,2,Rocky Mountain,,Wyoming,1936,N,N
8,1,0,7,FBS Independents,,Yale,1936,N,N
10,1,0,9,SEC,,Alabama,1937,N,N
10,2,0,8,Border,,Arizona,1937,N,N
9,9,0,0,Border,,Arizona State,1937,N,N
10,4,0,6,Southwest,,Arkansas,1937,N,N
9,2,0,7,FBS Independents,,Army,1937,N,N
11,3,0,8,SEC,,Auburn,1937,N,N
10,3,0,7,Southwest,,Baylor,1937,N,N
9,5,0,4,FBS Independents,,Boston College,1937,N,N
9,4,0,5,FBS Independents,,Brown,1937,N,N
8,5,0,3,FBS Independents,,Bucknell,1937,N,N
9,3,0,6,Rocky Mountain,,BYU,1937,N,N
11,1,0,10,Pacific,,California,1937,N,N
8,5,0,3,FBS Independents,,Carnegie Mellon,1937,N,N
12,5,0,7,FBS Independents,,Centenary (LA),1937,N,N
7,6,0,1,Western,,Chicago,1937,N,N
9,4,0,5,Southern,,Clemson,1937,N,N
8,5,0,3,FBS Independents,,Colgate,1937,N,N
9,1,0,8,Rocky Mountain,,Colorado,1937,N,N
9,4,0,5,Rocky Mountain,,Colorado College,1937,N,N
7,5,0,2,Rocky Mountain,,Colorado Mines,1937,N,N
8,7,0,1,Rocky Mountain,,Colorado State,1937,N,N
9,7,0,2,FBS Independents,,Columbia,1937,N,N
8,2,0,6,FBS Independents,,Cornell,1937,N,N
9,7,0,2,Missouri Valley,,Creighton,1937,N,N
9,1,0,8,FBS Independents,,Dartmouth,1937,N,N
10,8,0,2,Southern,,Davidson,1937,N,N
9,3,0,6,Rocky Mountain,,Denver,1937,N,N
10,3,0,7,FBS Independents,,Detroit Mercy,1937,N,N
10,2,0,8,Missouri Valley,,Drake,1937,N,N
10,3,0,7,Southern,,Duke,1937,N,N
10,4,0,6,FBS Independents,,Duquesne,1937,N,N
11,7,0,4,SEC,,Florida,1937,N,N
8,1,0,7,FBS Independents,,Fordham,1937,N,N
9,5,0,4,Southern,,Furman,1937,N,N
8,5,0,3,FBS Independents,,Georgetown,1937,N,N
8,4,0,4,FBS Independents,,George Washington,1937,N,N
11,3,0,8,SEC,,Georgia,1937,N,N
10,4,0,6,SEC,,Georgia Tech,1937,N,N
10,8,0,2,FBS Independents,,Gonzaga,1937,N,N
8,2,0,6,FBS Independents,,Harvard,1937,N,N
10,2,0,8,FBS Independents,,Holy Cross,1937,N,N
8,4,0,4,Pacific,,Idaho,1937,N,N
8,5,0,3,Western,,Illinois,1937,N,N
8,3,0,5,Western,,Indiana,1937,N,N
8,7,0,1,Western,,Iowa,1937,N,N
9,6,0,3,Big 6,,Iowa State,1937,N,N
9,5,0,4,Big 6,,Kansas,1937,N,N
9,5,0,4,Big 6,,Kansas State,1937,N,N
10,6,0,4,SEC,,Kentucky,1937,N,N
11,7,0,4,FBS Independents,,Loyola Marymount,1937,N,N
11,2,0,9,SEC,,LSU,1937,N,N
10,3,0,7,FBS Independents,,Manhattan,1937,N,N
9,6,0,3,FBS Independents,,Marquette,1937,N,N
10,2,0,8,Southern,,Maryland,1937,N,N
9,4,0,5,FBS Independents,,Miami,1937,N,N
8,4,0,4,Western,,Michigan,1937,N,N
10,2,0,8,FBS Independents,,Michigan State,1937,N,N
8,2,0,6,Western,,Minnesota,1937,N,N
10,4,0,6,SEC,,Mississippi State,1937,N,N
10,6,0,4,Big 6,,Missouri,1937,N,N
8,1,0,7,Pacific,,Montana,1937,N,N
8,4,0,4,Rocky Mountain,,Montana State,1937,N,N
9,5,0,4,FBS Independents,,Navy,1937,N,N
9,3,0,6,Southern,,NC State,1937,N,N
9,3,0,6,Big 6,,Nebraska,1937,N,N
9,5,0,4,Border,,New Mexico,1937,N,N
9,2,0,7,Border,,New Mexico State,1937,N,N
9,4,0,5,FBS Independents,,New York University,1937,N,N
9,2,0,7,Southern,,North Carolina,1937,N,N
10,5,0,5,Border,,Northern Arizona,1937,N,N
8,6,0,2,Rocky Mountain,,Northern Colorado,1937,N,N
8,4,0,4,Western,,Northwestern,1937,N,N
9,2,0,7,FBS Independents,,Notre Dame,1937,N,N
8,2,0,6,Western,,Ohio State,1937,N,N
9,3,0,6,Big 6,,Oklahoma,1937,N,N
10,6,0,4,Missouri Valley,,Oklahoma State,1937,N,N
10,5,0,5,SEC,,Ole Miss,1937,N,N
10,6,0,4,Pacific,,Oregon,1937,N,N
9,4,0,5,Pacific,,Oregon State,1937,N,N
8,3,0,5,FBS Independents,,Penn State,1937,N,N
10,0,0,10,FBS Independents,,Pittsburgh,1937,Y,N
8,4,0,4,FBS Independents,,Princeton,1937,N,N
8,3,0,5,Western,,Purdue,1937,N,N
11,5,0,6,Southwest,,Rice,1937,N,N
10,4,0,6,Southern,,Richmond,1937,N,N
10,2,0,8,Missouri Valley,,Saint Louis,1937,N,N
9,3,0,6,FBS Independents,,Saint Mary's (CA),1937,N,N
10,5,0,5,FBS Independents,,San Francisco,1937,N,N
9,0,0,9,FBS Independents,,Santa Clara,1937,N,N
9,7,0,2,SEC,,Sewanee Univ. of the South,1937,N,N
11,6,0,5,Southwest,,SMU,1937,N,N
12,6,0,6,Southern,,South Carolina,1937,N,N
9,4,0,5,Pacific,,Stanford,1937,N,N
8,2,0,6,FBS Independents,,Syracuse,1937,N,N
10,5,0,5,Southwest,,TCU,1937,N,N
9,3,0,6,FBS Independents,,Temple,1937,N,N
10,3,0,7,SEC,,Tennessee,1937,N,N
9,6,0,3,Southwest,,Texas,1937,N,N
9,2,0,7,Southwest,,Texas A&M,1937,N,N
12,4,0,8,Border,,Texas Tech,1937,N,N
11,4,0,7,Southern,,The Citadel,1937,N,N
10,5,0,5,SEC,,Tulane,1937,N,N
10,3,0,7,Missouri Valley,,Tulsa,1937,N,N
9,6,0,3,Pacific,,UCLA,1937,N,N
10,5,0,5,Pacific,,USC,1937,N,N
8,3,0,5,Rocky Mountain,,Utah,1937,N,N
8,5,0,3,Rocky Mountain,,Utah State,1937,N,N
10,1,0,9,Border,,UTEP,1937,N,N
9,2,0,7,SEC,,Vanderbilt,1937,N,N
9,1,0,8,FBS Independents,,Villanova,1937,N,N
9,7,0,2,FBS Independents,,Virginia,1937,N,N
10,5,0,5,Southern,,Virginia Tech,1937,N,N
10,5,0,5,Southern,,VMI,1937,N,N
9,6,0,3,Southern,,Wake Forest,1937,N,N
10,10,0,0,Missouri Valley,,Washburn,1937,N,N
11,2,0,9,Pacific,,Washington,1937,N,N
9,5,0,4,Southern,,Washington & Lee,1937,N,N
10,6,0,4,Missouri Valley,,Washington (MO),1937,N,N
9,5,0,4,Pacific,,Washington State,1937,N,N
8,3,0,5,Rocky Mountain,,Western State,1937,N,N
10,1,0,9,FBS Independents,,West Virginia,1937,N,N
9,5,0,4,Southern,,William & Mary,1937,N,N
8,4,0,4,Western,,Wisconsin,1937,N,N
8,5,0,3,Rocky Mountain,,Wyoming,1937,N,N
8,2,0,6,FBS Independents,,Yale,1937,N,N
9,1,0,8,SEC,,Alabama,1938,N,N
9,6,0,3,Border,,Arizona,1938,N,N
9,6,0,3,Border,,Arizona State,1938,N,N
10,7,0,3,Southwest,,Arkansas,1938,N,N
10,2,0,8,FBS Independents,,Army,1938,N,N
10,5,0,5,SEC,,Auburn,1938,N,N
10,3,0,7,Southwest,,Baylor,1938,N,N
9,2,0,7,FBS Independents,,Boston College,1938,N,N
8,3,0,5,FBS Independents,,Brown,1938,N,N
8,3,0,5,FBS Independents,,Bucknell,1938,N,N
8,3,0,5,Mountain State,,BYU,1938,N,N
11,1,0,10,Pacific,,California,1938,N,N
9,2,0,7,FBS Independents,,Carnegie Mellon,1938,N,N
11,4,0,7,FBS Independents,,Centenary (LA),1938,N,N
8,7,0,1,Western,,Chicago,1938,N,N
9,2,0,7,Southern,,Clemson,1938,N,N
7,5,0,2,FBS Independents,,Colgate,1938,N,N
8,5,0,3,Mountain State,,Colorado,1938,N,N
8,5,0,3,Mountain State,,Colorado State,1938,N,N
9,6,0,3,FBS Independents,,Columbia,1938,N,N
7,1,0,6,FBS Independents,,Cornell,1938,N,N
8,1,0,7,Missouri Valley,,Creighton,1938,N,N
9,2,0,7,FBS Independents,,Dartmouth,1938,N,N
10,6,0,4,Southern,,Davidson,1938,N,N
9,5,0,4,Mountain State,,Denver,1938,N,N
10,4,0,6,FBS Independents,,Detroit Mercy,1938,N,N
10,5,0,5,Missouri Valley,,Drake,1938,N,N
10,1,0,9,Southern,,Duke,1938,N,N
10,6,0,4,FBS Independents,,Duquesne,1938,N,N
11,6,0,5,SEC,,Florida,1938,N,N
9,3,0,6,FBS Independents,,Fordham,1938,N,N
10,7,0,3,Southern,,Furman,1938,N,N
8,0,0,8,FBS Independents,,Georgetown,1938,N,N
9,4,0,5,FBS Independents,,George Washington,1938,N,N
10,5,0,5,SEC,,Georgia,1938,N,N
10,6,0,4,SEC,,Georgia Tech,1938,N,N
8,7,0,1,FBS Independents,,Gonzaga,1938,N,N
8,6,0,2,FBS Independents,,Hampden-Sydney,1938,N,N
8,4,0,4,FBS Independents,,Harvard,1938,N,N
9,1,0,8,FBS Independents,,Holy Cross,1938,N,N
10,3,0,7,Pacific,,Idaho,1938,N,N
8,5,0,3,Western,,Illinois,1938,N,N
8,6,0,2,Western,,Indiana,1938,N,N
8,7,0,1,Western,,Iowa,1938,N,N
9,1,0,8,Big 6,,Iowa State,1938,N,N
9,6,0,3,Big 6,,Kansas,1938,N,N
9,5,0,4,Big 6,,Kansas State,1938,N,N
9,7,0,2,SEC,,Kentucky,1938,N,N
9,5,0,4,FBS Independents,,Loyola Marymount,1938,N,N
10,4,0,6,SEC,,LSU,1938,N,N
9,4,0,5,FBS Independents,,Manhattan,1938,N,N
8,7,0,1,FBS Independents,,Marquette,1938,N,N
9,7,0,2,Southern,,Maryland,1938,N,N
10,2,0,8,FBS Independents,,Miami,1938,N,N
8,2,0,6,Western,,Michigan,1938,N,N
9,3,0,6,FBS Independents,,Michigan State,1938,N,N
8,2,0,6,Western,,Minnesota,1938,N,N
10,6,0,4,SEC,,Mississippi State,1938,N,N
9,3,0,6,Big 6,,Missouri,1938,N,N
9,3,0,6,Pacific,,Montana,1938,N,N
9,4,0,5,FBS Independents,,Navy,1938,N,N
11,8,0,3,Southern,,NC State,1938,N,N
9,6,0,3,Big 6,,Nebraska,1938,N,N
11,3,0,8,Border,,New Mexico,1938,N,N
9,2,0,7,Border,,New Mexico State,1938,N,N
8,4,0,4,FBS Independents,,New York University,1938,N,N
9,2,0,7,Southern,,North Carolina,1938,N,N
9,6,0,3,Border,,Northern Arizona,1938,N,N
8,3,0,5,Western,,Northwestern,1938,N,N
9,1,0,8,FBS Independents,,Notre Dame,1938,N,N
8,3,0,5,Western,,Ohio State,1938,N,N
11,1,0,10,Big 6,,Oklahoma,1938,N,N
10,8,0,2,Missouri Valley,,Oklahoma State,1938,N,N
11,2,0,9,SEC,,Ole Miss,1938,N,N
9,5,0,4,Pacific,,Oregon,1938,N,N
9,3,0,6,Pacific,,Oregon State,1938,N,N
8,4,0,4,FBS Independents,,Penn State,1938,N,N
10,2,0,8,FBS Independents,,Pittsburgh,1938,N,N
8,4,0,4,FBS Independents,,Princeton,1938,N,N
8,1,0,7,Western,,Purdue,1938,N,N
10,6,0,4,Southwest,,Rice,1938,N,N
10,4,0,6,Southern,,Richmond,1938,N,N
10,5,0,5,Missouri Valley,,Saint Louis,1938,N,N
8,2,0,6,FBS Independents,,Saint Mary's (CA),1938,N,N
8,3,0,5,FBS Independents,,San Francisco,1938,N,N
8,2,0,6,FBS Independents,,Santa Clara,1938,N,N
9,8,0,1,SEC,,Sewanee Univ. of the South,1938,N,N
10,4,0,6,Southwest,,SMU,1938,N,N
11,5,0,6,Southern,,South Carolina,1938,N,N
9,6,0,3,Pacific,,Stanford,1938,N,N
8,3,0,5,FBS Independents,,Syracuse,1938,N,N
11,0,0,11,Southwest,,TCU,1938,Y,N
10,7,0,3,FBS Independents,,Temple,1938,N,N
11,0,0,11,SEC,,Tennessee,1938,N,N
9,8,0,1,Southwest,,Texas,1938,N,N
9,4,0,5,Southwest,,Texas A&M,1938,N,N
11,1,0,10,Border,,Texas Tech,1938,N,N
11,5,0,6,Southern,,The Citadel,1938,N,N
10,3,0,7,SEC,,Tulane,1938,N,N
10,6,0,4,Missouri Valley,,Tulsa,1938,N,N
12,5,0,7,Pacific,,UCLA,1938,N,N
11,2,0,9,Pacific,,USC,1938,N,N
10,2,0,8,Mountain State,,Utah,1938,N,N
8,4,0,4,Mountain State,,Utah State,1938,N,N
9,3,0,6,Border,,UTEP,1938,N,N
9,3,0,6,SEC,,Vanderbilt,1938,N,N
9,0,0,9,FBS Independents,,Villanova,1938,N,N
9,5,0,4,FBS Independents,,Virginia,1938,N,N
10,5,0,5,Southern,,Virginia Tech,1938,N,N
11,3,0,8,Southern,,VMI,1938,N,N
10,5,0,5,Southern,,Wake Forest,1938,N,N
9,3,0,6,Missouri Valley,,Washburn,1938,N,N
9,6,0,3,Pacific,,Washington,1938,N,N
9,5,0,4,Southern,,Washington & Lee,1938,N,N
10,4,0,6,Missouri Valley,,Washington (MO),1938,N,N
10,8,0,2,Pacific,,Washington State,1938,N,N
10,5,0,5,FBS Independents,,West Virginia,1938,N,N
10,7,0,3,Southern,,William & Mary,1938,N,N
8,3,0,5,Western,,Wisconsin,1938,N,N
8,6,0,2,Mountain State,,Wyoming,1938,N,N
8,6,0,2,FBS Independents,,Yale,1938,N,N
9,4,0,5,SEC,,Alabama,1939,N,N
10,4,0,6,Border,,Arizona,1939,N,N
11,3,0,8,Border,,Arizona State,1939,N,N
10,5,0,5,Southwest,,Arkansas,1939,N,N
9,5,0,4,FBS Independents,,Army,1939,N,N
11,6,0,5,SEC,,Auburn,1939,N,N
10,3,0,7,Southwest,,Baylor,1939,N,N
11,2,0,9,FBS Independents,,Boston College,1939,N,N
9,3,0,6,FBS Independents,,Brown,1939,N,N
8,5,0,3,FBS Independents,,Bucknell,1939,N,N
9,2,0,7,Mountain State,,BYU,1939,N,N
10,7,0,3,Pacific,,California,1939,N,N
8,5,0,3,FBS Independents,,Carnegie Mellon,1939,N,N
12,10,0,2,FBS Independents,,Centenary (LA),1939,N,N
8,6,0,2,Western,,Chicago,1939,N,N
10,1,0,9,Southern,,Clemson,1939,N,N
8,5,0,3,FBS Independents,,Colgate,1939,N,N
8,3,0,5,Mountain State,,Colorado,1939,N,N
9,7,0,2,Mountain State,,Colorado State,1939,N,N
8,6,0,2,FBS Independents,,Columbia,1939,N,N
8,0,0,8,FBS Independents,,Cornell,1939,N,N
9,5,0,4,Missouri Valley,,Creighton,1939,N,N
9,3,0,6,FBS Independents,,Dartmouth,1939,N,N
9,7,0,2,Southern,,Davidson,1939,N,N
9,4,0,5,Mountain State,,Denver,1939,N,N
9,3,0,6,FBS Independents,,Detroit Mercy,1939,N,N
10,5,0,5,Missouri Valley,,Drake,1939,N,N
9,1,0,8,Southern,,Duke,1939,N,N
9,1,0,8,FBS Independents,,Duquesne,1939,N,N
11,5,0,6,SEC,,Florida,1939,N,N
8,2,0,6,FBS Independents,,Fordham,1939,N,N
9,4,0,5,Southern,,Furman,1939,N,N
8,0,0,8,FBS Independents,,Georgetown,1939,N,N
8,3,0,5,FBS Independents,,George Washington,1939,N,N
11,6,0,5,SEC,,Georgia,1939,N,N
10,2,0,8,SEC,,Georgia Tech,1939,N,N
8,2,0,6,FBS Independents,,Gonzaga,1939,N,N
9,5,0,4,FBS Independents,,Hampden-Sydney,1939,N,N
9,2,0,7,FBS Independents,,Hardin-Simmons,1939,N,N
8,4,0,4,FBS Independents,,Harvard,1939,N,N
9,2,0,7,FBS Independents,,Holy Cross,1939,N,N
8,6,0,2,Pacific,,Idaho,1939,N,N
8,5,0,3,Western,,Illinois,1939,N,N
8,5,0,3,Western,,Indiana,1939,N,N
8,1,0,7,Western,,Iowa,1939,N,N
9,7,0,2,Big 6,,Iowa State,1939,N,N
8,6,0,2,Big 6,,Kansas,1939,N,N
9,5,0,4,Big 6,,Kansas State,1939,N,N
9,2,0,7,SEC,,Kentucky,1939,N,N
9,7,0,2,FBS Independents,,Loyola Marymount,1939,N,N
9,5,0,4,SEC,,LSU,1939,N,N
8,4,0,4,FBS Independents,,Manhattan,1939,N,N
8,4,0,4,FBS Independents,,Marquette,1939,N,N
9,7,0,2,Southern,,Maryland,1939,N,N
10,5,0,5,FBS Independents,,Miami,1939,N,N
8,2,0,6,Western,,Michigan,1939,N,N
9,5,0,4,FBS Independents,,Michigan State,1939,N,N
8,5,0,3,Western,,Minnesota,1939,N,N
10,2,0,8,SEC,,Mississippi State,1939,N,N
10,2,0,8,Big 6,,Missouri,1939,N,N
9,6,0,3,Pacific,,Montana,1939,N,N
9,6,0,3,FBS Independents,,Navy,1939,N,N
10,8,0,2,Southern,,NC State,1939,N,N
9,1,0,8,Big 6,,Nebraska,1939,N,N
10,2,0,8,Border,,New Mexico,1939,N,N
9,6,0,3,Border,,New Mexico State,1939,N,N
9,4,0,5,FBS Independents,,New York University,1939,N,N
10,1,0,9,Southern,,North Carolina,1939,N,N
8,6,0,2,Border,,Northern Arizona,1939,N,N
8,5,0,3,Western,,Northwestern,1939,N,N
9,2,0,7,FBS Independents,,Notre Dame,1939,N,N
8,2,0,6,Western,,Ohio State,1939,N,N
9,3,0,6,Big 6,,Oklahoma,1939,N,N
10,4,0,6,Missouri Valley,,Oklahoma State,1939,N,N
9,2,0,7,SEC,,Ole Miss,1939,N,N
8,4,0,4,Pacific,,Oregon,1939,N,N
11,1,0,10,Pacific,,Oregon State,1939,N,N
8,1,0,7,FBS Independents,,Penn State,1939,N,N
9,4,0,5,FBS Independents,,Pittsburgh,1939,N,N
8,1,0,7,FBS Independents,,Princeton,1939,N,N
8,3,0,5,Western,,Purdue,1939,N,N
9,6,0,3,FBS Independents,,Rhodes,1939,N,N
11,10,0,1,Southwest,,Rice,1939,N,N
10,2,0,8,Southern,,Richmond,1939,N,N
10,4,0,6,Missouri Valley,,Saint Louis,1939,N,N
8,5,0,3,FBS Independents,,Saint Mary's (CA),1939,N,N
10,5,0,5,FBS Independents,,San Francisco,1939,N,N
9,1,0,8,FBS Independents,,Santa Clara,1939,N,N
8,5,0,3,SEC,,Sewanee Univ. of the South,1939,N,N
10,3,0,7,Southwest,,SMU,1939,N,N
10,7,0,3,Southern,,South Carolina,1939,N,N
9,8,0,1,Pacific,,Stanford,1939,N,N
8,5,0,3,FBS Independents,,Syracuse,1939,N,N
10,7,0,3,Southwest,,TCU,1939,N,N
9,7,0,2,FBS Independents,,Temple,1939,N,N
11,1,0,10,SEC,,Tennessee,1939,N,N
9,4,0,5,Southwest,,Texas,1939,N,N
11,0,0,11,Southwest,,Texas A&M,1939,Y,N
11,5,0,6,Border,,Texas Tech,1939,N,N
11,8,0,3,Southern,,The Citadel,1939,N,N
10,2,0,8,SEC,,Tulane,1939,N,N
10,6,0,4,Missouri Valley,,Tulsa,1939,N,N
10,3,0,7,Pacific,,UCLA,1939,N,N
10,1,0,9,Pacific,,USC,1939,N,N
9,2,0,7,Mountain State,,Utah,1939,N,N
8,5,0,3,Mountain State,,Utah State,1939,N,N
9,4,0,5,Border,,UTEP,1939,N,N
10,8,0,2,SEC,,Vanderbilt,1939,N,N
8,2,0,6,FBS Independents,,Villanova,1939,N,N
9,4,0,5,FBS Independents,,Virginia,1939,N,N
10,6,0,4,Southern,,Virginia Tech,1939,N,N
10,3,0,7,Southern,,VMI,1939,N,N
10,3,0,7,Southern,,Wake Forest,1939,N,N
10,4,0,6,Missouri Valley,,Washburn,1939,N,N
9,5,0,4,Pacific,,Washington,1939,N,N
8,4,0,4,Southern,,Washington & Lee,1939,N,N
10,3,0,7,Missouri Valley,,Washington (MO),1939,N,N
9,5,0,4,Pacific,,Washington State,1939,N,N
9,6,0,3,FBS Independents,,West Virginia,1939,N,N
9,2,0,7,Southern,,William & Mary,1939,N,N
8,7,0,1,Western,,Wisconsin,1939,N,N
8,8,0,0,Mountain State,,Wyoming,1939,N,N
8,5,0,3,FBS Independents,,Yale,1939,N,N
9,2,0,7,SEC,,Alabama,1940,N,N
9,2,0,7,Border,,Arizona,1940,N,N
11,3,0,8,Border,,Arizona State,1940,N,N
10,6,0,4,Southwest,,Arkansas,1940,N,N
9,7,0,2,FBS Independents,,Army,1940,N,N
11,5,0,6,SEC,,Auburn,1940,N,N
10,6,0,4,Southwest,,Baylor,1940,N,N
11,0,0,11,FBS Independents,,Boston College,1940,N,N
10,4,0,6,FBS Independents,,Brown,1940,N,N
8,5,0,3,Mountain State,,BYU,1940,N,N
10,6,0,4,Pacific,,California,1940,N,N
8,5,0,3,FBS Independents,,Carnegie Mellon,1940,N,N
10,7,0,3,FBS Independents,,Centenary (LA),1940,N,N
9,2,0,7,Southern,,Clemson,1940,N,N
8,3,0,5,FBS Independents,,Colgate,1940,N,N
9,3,0,6,Mountain State,,Colorado,1940,N,N
9,5,0,4,Mountain State,,Colorado State,1940,N,N
9,3,0,6,FBS Independents,,Columbia,1940,N,N
8,2,0,6,FBS Independents,,Cornell,1940,N,N
10,3,0,7,Missouri Valley,,Creighton,1940,N,N
9,4,0,5,FBS Independents,,Dartmouth,1940,N,N
10,5,0,5,Southern,,Davidson,1940,N,N
9,3,0,6,Mountain State,,Denver,1940,N,N
9,2,0,7,FBS Independents,,Detroit Mercy,1940,N,N
9,5,0,4,Missouri Valley,,Drake,1940,N,N
9,2,0,7,Southern,,Duke,1940,N,N
8,1,0,7,FBS Independents,,Duquesne,1940,N,N
10,5,0,5,SEC,,Florida,1940,N,N
9,2,0,7,FBS Independents,,Fordham,1940,N,N
9,4,0,5,Southern,,Furman,1940,N,N
10,2,0,8,FBS Independents,,Georgetown,1940,N,N
9,4,0,5,FBS Independents,,George Washington,1940,N,N
10,5,0,5,SEC,,Georgia,1940,N,N
10,7,0,3,SEC,,Georgia Tech,1940,N,N
10,4,0,6,FBS Independents,,Gonzaga,1940,N,N
9,5,0,4,FBS Independents,,Hampden-Sydney,1940,N,N
9,0,0,9,FBS Independents,,Hardin-Simmons,1940,N,N
8,4,0,4,FBS Independents,,Harvard,1940,N,N
10,6,0,4,FBS Independents,,Holy Cross,1940,N,N
9,8,0,1,Pacific,,Idaho,1940,N,N
8,7,0,1,Western,,Illinois,1940,N,N
8,5,0,3,Western,,Indiana,1940,N,N
8,4,0,4,Western,,Iowa,1940,N,N
9,5,0,4,Big 6,,Iowa State,1940,N,N
9,7,0,2,Big 6,,Kansas,1940,N,N
9,7,0,2,Big 6,,Kansas State,1940,N,N
10,3,0,7,SEC,,Kentucky,1940,N,N
10,7,0,3,FBS Independents,,Loyola Marymount,1940,N,N
10,4,0,6,SEC,,LSU,1940,N,N
9,6,0,3,FBS Independents,,Manhattan,1940,N,N
9,6,0,3,FBS Independents,,Marquette,1940,N,N
9,7,0,2,Southern,,Maryland,1940,N,N
10,7,0,3,FBS Independents,,Miami,1940,N,N
8,1,0,7,Western,,Michigan,1940,N,N
8,5,0,3,FBS Independents,,Michigan State,1940,N,N
8,0,0,8,Western,,Minnesota,1940,Y,N
11,0,0,11,SEC,,Mississippi State,1940,N,N
9,3,0,6,Big 6,,Missouri,1940,N,N
9,4,0,5,Pacific,,Montana,1940,N,N
9,2,0,7,FBS Independents,,Navy,1940,N,N
9,6,0,3,Southern,,NC State,1940,N,N
10,2,0,8,Big 6,,Nebraska,1940,N,N
9,4,0,5,Border,,New Mexico,1940,N,N
9,6,0,3,Border,,New Mexico State,1940,N,N
9,7,0,2,FBS Independents,,New York University,1940,N,N
10,4,0,6,Southern,,North Carolina,1940,N,N
8,6,0,2,Border,,Northern Arizona,1940,N,N
8,2,0,6,Western,,Northwestern,1940,N,N
9,2,0,7,FBS Independents,,Notre Dame,1940,N,N
8,4,0,4,Western,,Ohio State,1940,N,N
9,3,0,6,Big 6,,Oklahoma,1940,N,N
10,3,0,7,Missouri Valley,,Oklahoma State,1940,N,N
11,2,0,9,SEC,,Ole Miss,1940,N,N
9,4,0,5,Pacific,,Oregon,1940,N,N
9,3,0,6,Pacific,,Oregon State,1940,N,N
8,1,0,7,FBS Independents,,Penn State,1940,N,N
8,5,0,3,FBS Independents,,Pittsburgh,1940,N,N
8,2,0,6,FBS Independents,,Princeton,1940,N,N
8,6,0,2,Western,,Purdue,1940,N,N
10,3,0,7,Southwest,,Rice,1940,N,N
9,3,0,6,Southern,,Richmond,1940,N,N
10,6,0,4,Missouri Valley,,Saint Louis,1940,N,N
8,3,0,5,FBS Independents,,Saint Mary's (CA),1940,N,N
8,7,0,1,FBS Independents,,San Francisco,1940,N,N
8,1,0,7,FBS Independents,,Santa Clara,1940,N,N
8,5,0,3,FBS Independents,,Sewanee Univ. of the South,1940,N,N
10,1,0,9,Southwest,,SMU,1940,N,N
9,6,0,3,Southern,,South Carolina,1940,N,N
10,0,0,10,Pacific,,Stanford,1940,N,N
8,5,0,3,FBS Independents,,Syracuse,1940,N,N
10,7,0,3,Southwest,,TCU,1940,N,N
9,4,0,5,FBS Independents,,Temple,1940,N,N
11,1,0,10,SEC,,Tennessee,1940,N,N
10,2,0,8,Southwest,,Texas,1940,N,N
10,1,0,9,Southwest,,Texas A&M,1940,N,N
11,2,0,9,Border,,Texas Tech,1940,N,N
9,5,0,4,Southern,,The Citadel,1940,N,N
10,5,0,5,SEC,,Tulane,1940,N,N
10,3,0,7,Missouri Valley,,Tulsa,1940,N,N
10,9,0,1,Pacific,,UCLA,1940,N,N
9,6,0,3,Pacific,,USC,1940,N,N
9,2,0,7,Mountain State,,Utah,1940,N,N
8,5,0,3,Mountain State,,Utah State,1940,N,N
9,5,0,4,Border,,UTEP,1940,N,N
10,7,0,3,SEC,,Vanderbilt,1940,N,N
9,5,0,4,FBS Independents,,Villanova,1940,N,N
9,5,0,4,FBS Independents,,Virginia,1940,N,N
10,5,0,5,Southern,,Virginia Tech,1940,N,N
10,3,0,7,Southern,,VMI,1940,N,N
10,3,0,7,Southern,,Wake Forest,1940,N,N
10,6,0,4,Missouri Valley,,Washburn,1940,N,N
9,2,0,7,Pacific,,Washington,1940,N,N
10,7,0,3,Southern,,Washington & Lee,1940,N,N
9,6,0,3,Missouri Valley,,Washington (MO),1940,N,N
10,5,0,5,Pacific,,Washington State,1940,N,N
9,5,0,4,FBS Independents,,West Virginia,1940,N,N
9,2,0,7,Southern,,William & Mary,1940,N,N
8,4,0,4,Western,,Wisconsin,1940,N,N
9,8,0,1,Mountain State,,Wyoming,1940,N,N
8,7,0,1,FBS Independents,,Yale,1940,N,N
11,2,0,9,SEC,,Alabama,1941,N,N
10,3,0,7,Border,,Arizona,1941,N,N
11,6,0,5,Border,,Arizona State,1941,N,N
10,7,0,3,Southwest,,Arkansas,1941,N,N
9,4,0,5,FBS Independents,,Army,1941,N,N
10,5,0,5,SEC,,Auburn,1941,N,N
10,7,0,3,Southwest,,Baylor,1941,N,N
10,3,0,7,FBS Independents,,Boston College,1941,N,N
9,4,0,5,FBS Independents,,Brown,1941,N,N
9,4,0,5,Mountain State,,BYU,1941,N,N
9,5,0,4,Pacific,,California,1941,N,N
10,10,0,0,FBS Independents,,Centenary (LA),1941,N,N
9,2,0,7,Southern,,Clemson,1941,N,N
8,4,0,4,FBS Independents,,Colgate,1941,N,N
8,4,0,4,Mountain State,,Colorado,1941,N,N
7,2,0,5,Mountain State,,Colorado State,1941,N,N
8,5,0,3,FBS Independents,,Columbia,1941,N,N
8,3,0,5,FBS Independents,,Cornell,1941,N,N
10,5,0,5,Missouri Valley,,Creighton,1941,N,N
9,4,0,5,FBS Independents,,Dartmouth,1941,N,N
10,8,0,2,Southern,,Davidson,1941,N,N
9,5,0,4,Mountain State,,Denver,1941,N,N
9,2,0,7,FBS Independents,,Detroit Mercy,1941,N,N
10,5,0,5,Missouri Valley,,Drake,1941,N,N
10,1,0,9,Southern,,Duke,1941,N,N
8,0,0,8,FBS Independents,,Duquesne,1941,N,N
10,6,0,4,SEC,,Florida,1941,N,N
9,1,0,8,FBS Independents,,Fordham,1941,N,N
9,5,0,4,Southern,,Furman,1941,N,N
9,4,0,5,FBS Independents,,Georgetown,1941,N,N
9,8,0,1,Southern,,George Washington,1941,N,N
11,2,0,9,SEC,,Georgia,1941,N,N
9,6,0,3,SEC,,Georgia Tech,1941,N,N
10,7,0,3,FBS Independents,,Gonzaga,1941,N,N
11,3,0,8,Border,,Hardin-Simmons,1941,N,N
8,3,0,5,FBS Independents,,Harvard,1941,N,N
10,5,0,5,FBS Independents,,Holy Cross,1941,N,N
9,5,0,4,Pacific,,Idaho,1941,N,N
8,6,0,2,Western,,Illinois,1941,N,N
8,6,0,2,Western,,Indiana,1941,N,N
8,5,0,3,Western,,Iowa,1941,N,N
9,7,0,2,Big 6,,Iowa State,1941,N,N
9,6,0,3,Big 6,,Kansas,1941,N,N
9,6,0,3,Big 6,,Kansas State,1941,N,N
9,4,0,5,SEC,,Kentucky,1941,N,N
10,5,0,5,FBS Independents,,Loyola Marymount,1941,N,N
10,6,0,4,SEC,,LSU,1941,N,N
9,4,0,5,FBS Independents,,Manhattan,1941,N,N
9,5,0,4,FBS Independents,,Marquette,1941,N,N
9,6,0,3,Southern,,Maryland,1941,N,N
10,2,0,8,FBS Independents,,Miami,1941,N,N
8,2,0,6,Western,,Michigan,1941,N,N
9,3,0,6,FBS Independents,,Michigan State,1941,N,N
8,0,0,8,Western,,Minnesota,1941,Y,N
10,1,0,9,SEC,,Mississippi State,1941,N,N
10,2,0,8,Big 6,,Missouri,1941,N,N
9,3,0,6,Pacific,,Montana,1941,N,N
9,1,0,8,FBS Independents,,Navy,1941,N,N
11,5,0,6,Southern,,NC State,1941,N,N
9,5,0,4,Big 6,,Nebraska,1941,N,N
10,4,0,6,Border,,New Mexico,1941,N,N
9,7,0,2,Border,,New Mexico State,1941,N,N
9,7,0,2,FBS Independents,,New York University,1941,N,N
10,7,0,3,Southern,,North Carolina,1941,N,N
8,5,0,3,Border,,Northern Arizona,1941,N,N
8,3,0,5,Western,,Northwestern,1941,N,N
9,0,0,9,FBS Independents,,Notre Dame,1941,N,N
8,1,0,7,Western,,Ohio State,1941,N,N
9,3,0,6,Big 6,,Oklahoma,1941,N,N
9,4,0,5,Missouri Valley,,Oklahoma State,1941,N,N
9,2,0,7,SEC,,Ole Miss,1941,N,N
10,5,0,5,Pacific,,Oregon,1941,N,N
10,2,0,8,Pacific,,Oregon State,1941,N,N
9,2,0,7,FBS Independents,,Penn State,1941,N,N
9,6,0,3,FBS Independents,,Pittsburgh,1941,N,N
8,6,0,2,FBS Independents,,Princeton,1941,N,N
8,6,0,2,Western,,Purdue,1941,N,N
10,3,0,7,Southwest,,Rice,1941,N,N
9,7,0,2,Southern,,Richmond,1941,N,N
10,6,0,4,Missouri Valley,,Saint Louis,1941,N,N
9,4,0,5,FBS Independents,,Saint Mary's (CA),1941,N,N
10,4,0,6,FBS Independents,,San Francisco,1941,N,N
9,3,0,6,FBS Independents,,Santa Clara,1941,N,N
7,5,0,2,FBS Independents,,Sewanee Univ. of the South,1941,N,N
10,5,0,5,Southwest,,SMU,1941,N,N
9,5,0,4,Southern,,South Carolina,1941,N,N
9,3,0,6,Pacific,,Stanford,1941,N,N
8,3,0,5,FBS Independents,,Syracuse,1941,N,N
11,4,0,7,Southwest,,TCU,1941,N,N
9,2,0,7,FBS Independents,,Temple,1941,N,N
10,2,0,8,SEC,,Tennessee,1941,N,N
10,1,0,9,Southwest,,Texas,1941,N,N
11,2,0,9,Southwest,,Texas A&M,1941,N,N
11,2,0,9,Border,,Texas Tech,1941,N,N
8,4,0,4,Southern,,The Citadel,1941,N,N
9,4,0,5,SEC,,Tulane,1941,N,N
10,2,0,8,Missouri Valley,,Tulsa,1941,N,N
11,6,0,5,Pacific,,UCLA,1941,N,N
9,6,0,3,Pacific,,USC,1941,N,N
8,1,0,7,Mountain State,,Utah,1941,N,N
8,8,0,0,Mountain State,,Utah State,1941,N,N
10,6,0,4,Border,,UTEP,1941,N,N
10,2,0,8,SEC,,Vanderbilt,1941,N,N
8,4,0,4,FBS Independents,,Villanova,1941,N,N
9,1,0,8,FBS Independents,,Virginia,1941,N,N
10,4,0,6,Southern,,Virginia Tech,1941,N,N
10,6,0,4,Southern,,VMI,1941,N,N
11,5,0,6,Southern,,Wake Forest,1941,N,N
9,4,0,5,Pacific,,Washington,1941,N,N
9,7,0,2,Southern,,Washington & Lee,1941,N,N
9,5,0,4,Missouri Valley,,Washington (MO),1941,N,N
10,4,0,6,Pacific,,Washington State,1941,N,N
10,2,0,8,Border,,West Texas A&M,1941,N,N
10,6,0,4,FBS Independents,,West Virginia,1941,N,N
10,2,0,8,Southern,,William & Mary,1941,N,N
8,5,0,3,Western,,Wisconsin,1941,N,N
10,8,0,2,Mountain State,,Wyoming,1941,N,N
8,7,0,1,FBS Independents,,Yale,1941,N,N
11,3,0,8,SEC,,Alabama,1942,N,N
10,4,0,6,Border,,Arizona,1942,N,N
10,8,0,2,Border,,Arizona State,1942,N,N
10,7,0,3,Southwest,,Arkansas,1942,N,N
9,3,0,6,FBS Independents,,Army,1942,N,N
11,4,0,7,SEC,,Auburn,1942,N,N
11,5,0,6,Southwest,,Baylor,1942,N,N
10,2,0,8,FBS Independents,,Boston College,1942,N,N
8,4,0,4,FBS Independents,,Brown,1942,N,N
7,5,0,2,Mountain State,,BYU,1942,N,N
10,5,0,5,Pacific,,California,1942,N,N
10,6,0,4,Southern,,Clemson,1942,N,N
9,2,0,7,FBS Independents,,Colgate,1942,N,N
9,2,0,7,Mountain State,,Colorado,1942,N,N
7,3,0,4,Mountain State,,Colorado State,1942,N,N
9,6,0,3,FBS Independents,,Columbia,1942,N,N
9,6,0,3,FBS Independents,,Cornell,1942,N,N
9,4,0,5,Missouri Valley,,Creighton,1942,N,N
9,4,0,5,FBS Independents,,Dartmouth,1942,N,N
9,7,0,2,Southern,,Davidson,1942,N,N
10,4,0,6,Mountain State,,Denver,1942,N,N
9,4,0,5,FBS Independents,,Detroit Mercy,1942,N,N
10,7,0,3,Missouri Valley,,Drake,1942,N,N
10,4,0,6,Southern,,Duke,1942,N,N
10,4,0,6,FBS Independents,,Duquesne,1942,N,N
10,7,0,3,SEC,,Florida,1942,N,N
9,4,0,5,FBS Independents,,Fordham,1942,N,N
9,6,0,3,Southern,,Furman,1942,N,N
9,4,0,5,FBS Independents,,Georgetown,1942,N,N
9,6,0,3,Southern,,George Washington,1942,N,N
12,1,0,11,SEC,,Georgia,1942,N,N
9,2,0,7,FBS Independents,,Georgia Pre-Flight,1942,N,N
11,2,0,9,SEC,,Georgia Tech,1942,N,N
12,4,0,8,FBS Independents,,Great Lakes Navy,1942,N,N
11,1,0,10,Border,,Hardin-Simmons,1942,N,N
9,7,0,2,FBS Independents,,Harvard,1942,N,N
10,5,0,5,FBS Independents,,Holy Cross,1942,N,N
10,7,0,3,Pacific,,Idaho,1942,N,N
10,4,0,6,Western,,Illinois,1942,N,N
10,3,0,7,Western,,Indiana,1942,N,N
10,4,0,6,Western,,Iowa,1942,N,N
10,3,0,7,FBS Independents,,Iowa Pre-Flight,1942,N,N
9,6,0,3,Big 6,,Iowa State,1942,N,N
12,3,0,9,FBS Independents,,Jacksonville Naval Air Station,1942,N,N
10,8,0,2,Big 6,,Kansas,1942,N,N
11,8,0,3,Big 6,,Kansas State,1942,N,N
10,6,0,4,SEC,,Kentucky,1942,N,N
10,5,0,5,FBS Independents,,Loyola Marymount,1942,N,N
10,3,0,7,SEC,,LSU,1942,N,N
8,6,0,2,FBS Independents,,Manhattan,1942,N,N
9,2,0,7,FBS Independents,,Marquette,1942,N,N
9,2,0,7,Southern,,Maryland,1942,N,N
9,2,0,7,FBS Independents,,Miami,1942,N,N
10,3,0,7,Western,,Michigan,1942,N,N
9,4,0,5,FBS Independents,,Michigan State,1942,N,N
9,4,0,5,Western,,Minnesota,1942,N,N
10,2,0,8,SEC,,Mississippi State,1942,N,N
12,3,0,9,Big 6,,Missouri,1942,N,N
8,8,0,0,Pacific,,Montana,1942,N,N
9,4,0,5,FBS Independents,,Navy,1942,N,N
10,5,0,5,Southern,,NC State,1942,N,N
10,7,0,3,Big 6,,Nebraska,1942,N,N
11,5,0,6,Border,,New Mexico,1942,N,N
9,8,0,1,Border,,New Mexico State,1942,N,N
9,3,0,6,Southern,,North Carolina,1942,N,N
11,2,0,9,FBS Independents,,North Carolina Pre-Flight,1942,N,N
6,5,0,1,Border,,Northern Arizona,1942,N,N
10,9,0,1,Western,,Northwestern,1942,N,N
11,2,0,9,FBS Independents,,Notre Dame,1942,N,N
10,1,0,9,Western,,Ohio State,1942,Y,N
10,6,0,4,Big 6,,Oklahoma,1942,N,N
10,4,0,6,Missouri Valley,,Oklahoma State,1942,N,N
9,7,0,2,SEC,,Ole Miss,1942,N,N
8,6,0,2,Pacific,,Oregon,1942,N,N
10,5,0,5,Pacific,,Oregon State,1942,N,N
8,1,0,7,FBS Independents,,Penn State,1942,N,N
9,6,0,3,FBS Independents,,Pittsburgh,1942,N,N
9,5,0,4,FBS Independents,,Princeton,1942,N,N
9,8,0,1,Western,,Purdue,1942,N,N
10,3,0,7,Southwest,,Rice,1942,N,N
10,7,0,3,Southern,,Richmond,1942,N,N
9,5,0,4,Missouri Valley,,Saint Louis,1942,N,N
10,3,0,7,FBS Independents,,Saint Mary's (CA),1942,N,N
10,3,0,7,FBS Independents,,Saint Mary's (CA) Pre-Flight,1942,N,N
10,4,0,6,FBS Independents,,San Francisco,1942,N,N
9,2,0,7,FBS Independents,,Santa Clara,1942,N,N
11,7,0,4,Southwest,,SMU,1942,N,N
9,8,0,1,Southern,,South Carolina,1942,N,N
10,4,0,6,Pacific,,Stanford,1942,N,N
9,3,0,6,FBS Independents,,Syracuse,1942,N,N
10,3,0,7,Southwest,,TCU,1942,N,N
10,7,0,3,FBS Independents,,Temple,1942,N,N
11,1,0,10,SEC,,Tennessee,1942,N,N
11,2,0,9,Southwest,,Texas,1942,N,N
10,5,0,5,Southwest,,Texas A&M,1942,N,N
10,6,0,4,Border,,Texas Tech,1942,N,N
7,2,0,5,Southern,,The Citadel,1942,N,N
9,5,0,4,SEC,,Tulane,1942,N,N
11,1,0,10,Missouri Valley,,Tulsa,1942,N,N
11,4,0,7,Pacific,,UCLA,1942,N,N
11,5,0,6,Pacific,,USC,1942,N,N
9,3,0,6,Mountain State,,Utah,1942,N,N
10,3,0,7,Mountain State,,Utah State,1942,N,N
9,4,0,5,Border,,UTEP,1942,N,N
10,4,0,6,SEC,,Vanderbilt,1942,N,N
8,4,0,4,FBS Independents,,Villanova,1942,N,N
9,6,0,3,FBS Independents,,Virginia,1942,N,N
10,3,0,7,Southern,,Virginia Tech,1942,N,N
9,6,0,3,Southern,,VMI,1942,N,N
9,2,0,7,Southern,,Wake Forest,1942,N,N
10,6,0,4,Pacific,,Washington,1942,N,N
9,8,0,1,Southern,,Washington & Lee,1942,N,N
10,5,0,5,Missouri Valley,,Washington (MO),1942,N,N
10,3,0,7,Pacific,,Washington State,1942,N,N
9,2,0,7,Border,,West Texas A&M,1942,N,N
9,4,0,5,FBS Independents,,West Virginia,1942,N,N
11,1,0,10,Southern,,William & Mary,1942,N,N
10,2,0,8,Western,,Wisconsin,1942,N,N
8,5,0,3,Mountain State,,Wyoming,1942,N,N
8,3,0,5,FBS Independents,,Yale,1942,N,N
7,3,0,4,FBS Independents,,Alameda Coast Guard,1943,N,N
9,7,0,2,Southwest,,Arkansas,1943,N,N
10,2,0,8,FBS Independents,,Army,1943,N,N
8,3,0,5,FBS Independents,,Brown,1943,N,N
10,6,0,4,Pacific,,California,1943,N,N
10,7,0,3,FBS Independents,,Camp Grant,1943,N,N
8,6,0,2,Southern,,Clemson,1943,N,N
9,3,0,6,FBS Independents,,Colgate,1943,N,N
7,2,0,5,Mountain State,,Colorado,1943,N,N
7,0,0,7,FBS Independents,,Colorado College,1943,N,N
8,8,0,0,FBS Independents,,Columbia,1943,N,N
10,4,0,6,FBS Independents,,Cornell,1943,N,N
7,1,0,6,FBS Independents,,Dartmouth,1943,N,N
8,1,0,7,FBS Independents,,Del Monte Pre-Flight,1943,N,N
7,5,0,2,Mountain State,,Denver,1943,N,N
9,1,0,8,Southern,,Duke,1943,N,N
9,3,0,6,FBS Independents,,Fort Riley,1943,N,N
10,4,0,6,SEC,,Georgia,1943,N,N
6,1,0,5,FBS Independents,,Georgia Pre-Flight,1943,N,N
11,3,0,8,SEC,,Georgia Tech,1943,N,N
12,2,0,10,FBS Independents,,Great Lakes Navy,1943,N,N
8,2,0,6,FBS Independents,,Holy Cross,1943,N,N
10,7,0,3,Western,,Illinois,1943,N,N
10,5,0,5,Western,,Indiana,1943,N,N
8,7,0,1,Western,,Iowa,1943,N,N
10,1,0,9,FBS Independents,,Iowa Pre-Flight,1943,N,N
8,4,0,4,Big 6,,Iowa State,1943,N,N
10,5,0,5,Big 6,,Kansas,1943,N,N
8,7,0,1,Big 6,,Kansas State,1943,N,N
9,3,0,6,SEC,,LSU,1943,N,N
10,1,0,9,FBS Independents,,March Field,1943,N,N
8,4,0,4,FBS Independents,,Marquette,1943,N,N
9,5,0,4,Southern,,Maryland,1943,N,N
9,1,0,8,Western,,Michigan,1943,N,N
9,4,0,5,Western,,Minnesota,1943,N,N
8,5,0,3,Big 6,,Missouri,1943,N,N
9,1,0,8,FBS Independents,,Navy,1943,N,N
9,6,0,3,Southern,,NC State,1943,N,N
8,6,0,2,Big 6,,Nebraska,1943,N,N
9,3,0,6,Southern,,North Carolina,1943,N,N
7,5,0,2,FBS Independents,,North Carolina Pre-Flight,1943,N,N
8,2,0,6,Western,,Northwestern,1943,N,N
10,1,0,9,FBS Independents,,Notre Dame,1943,Y,N
9,6,0,3,Western,,Ohio State,1943,N,N
9,2,0,7,Big 6,,Oklahoma,1943,N,N
7,4,0,3,Missouri Valley,,Oklahoma State,1943,N,N
9,2,0,7,FBS Independents,,Pacific,1943,N,N
9,4,0,5,FBS Independents,,Penn State,1943,N,N
8,5,0,3,FBS Independents,,Pittsburgh,1943,N,N
7,6,0,1,FBS Independents,,Princeton,1943,N,N
9,0,0,9,Western,,Purdue,1943,N,N
10,7,0,3,Southwest,,Rice,1943,N,N
7,1,0,6,Southern,,Richmond,1943,N,N
7,5,0,2,FBS Independents,,Saint Mary's (CA),1943,N,N
8,4,0,4,FBS Independents,,Saint Mary's (CA) Pre-Flight,1943,N,N
8,7,0,1,FBS Independents,,San Francisco,1943,N,N
9,7,0,2,Southwest,,SMU,1943,N,N
7,2,0,5,Southern,,South Carolina,1943,N,N
8,6,0,2,Southwest,,TCU,1943,N,N
8,6,0,2,FBS Independents,,Temple,1943,N,N
9,1,0,8,Southwest,,Texas,1943,N,N
10,3,0,7,Southwest,,Texas A&M,1943,N,N
10,6,0,4,FBS Independents,,Texas Tech,1943,N,N
6,3,0,3,SEC,,Tulane,1943,N,N
8,2,0,6,Missouri Valley,,Tulsa,1943,N,N
9,8,0,1,Pacific,,UCLA,1943,N,N
10,2,0,8,Pacific,,USC,1943,N,N
7,7,0,0,Mountain State,,Utah,1943,N,N
8,3,0,5,FBS Independents,,Villanova,1943,N,N
8,5,0,3,FBS Independents,,Virginia,1943,N,N
8,6,0,2,Southern,,VMI,1943,N,N
9,5,0,4,Southern,,Wake Forest,1943,N,N
7,3,0,4,FBS Independents,,West Virginia,1943,N,N
10,9,0,1,Western,,Wisconsin,1943,N,N
9,5,0,4,FBS Independents,,Yale,1943,N,N
9,2,0,7,SEC,,Alabama,1944,N,N
8,4,0,4,FBS Independents,,Alameda Coast Guard,1944,N,N
9,4,0,5,FBS Independents,,Amarillo Field,1944,N,N
11,5,0,6,Southwest,,Arkansas,1944,N,N
9,0,0,9,FBS Independents,,Army,1944,Y,N
8,4,0,4,SEC,,Auburn,1944,N,N
7,3,0,4,FBS Independents,,Boston College,1944,N,N
8,4,0,4,FBS Independents,,Brown,1944,N,N
10,2,0,8,FBS Independents,,Bucknell,1944,N,N
10,6,0,4,Pacific,,California,1944,N,N
9,5,0,4,Southern,,Clemson,1944,N,N
9,3,0,6,FBS Independents,,Coast Guard,1944,N,N
7,5,0,2,FBS Independents,,Colgate,1944,N,N
8,2,0,6,Mountain State,,Colorado,1944,N,N
10,7,0,3,FBS Independents,,Colorado College,1944,N,N
8,6,0,2,FBS Independents,,Columbia,1944,N,N
9,4,0,5,FBS Independents,,Cornell,1944,N,N
8,6,0,2,FBS Independents,,Dartmouth,1944,N,N
9,4,0,5,Mountain State,,Denver,1944,N,N
9,2,0,7,Missouri Valley,,Drake,1944,N,N
10,4,0,6,Southern,,Duke,1944,N,N
7,3,0,4,SEC,,Florida,1944,N,N
11,5,0,6,FBS Independents,,Fort Warren,1944,N,N
10,3,0,7,SEC,,Georgia,1944,N,N
11,3,0,8,SEC,,Georgia Tech,1944,N,N
12,3,0,9,FBS Independents,,Great Lakes Navy,1944,N,N
9,3,0,6,FBS Independents,,Holy Cross,1944,N,N
9,5,0,4,FBS Independents,,Idaho State,1944,N,N
10,4,0,6,Western,,Illinois,1944,N,N
10,3,0,7,Western,,Indiana,1944,N,N
8,7,0,1,Western,,Iowa,1944,N,N
11,1,0,10,FBS Independents,,Iowa Pre-Flight,1944,N,N
8,1,0,7,Big 6,,Iowa State,1944,N,N
10,6,0,4,Big 6,,Kansas,1944,N,N
9,7,0,2,Big 6,,Kansas State,1944,N,N
9,6,0,3,SEC,,Kentucky,1944,N,N
8,6,0,2,SEC,,LSU,1944,N,N
9,4,0,5,FBS Independents,,Lubbock Field,1944,N,N
12,2,0,10,FBS Independents,,March Field,1944,N,N
8,7,0,1,FBS Independents,,Marquette,1944,N,N
9,8,0,1,Southern,,Maryland,1944,N,N
9,8,0,1,FBS Independents,,Miami,1944,N,N
10,2,0,8,Western,,Michigan,1944,N,N
7,1,0,6,FBS Independents,,Michigan State,1944,N,N
9,4,0,5,Western,,Minnesota,1944,N,N
8,2,0,6,SEC,,Mississippi State,1944,N,N
10,6,0,4,Big 6,,Missouri,1944,N,N
9,3,0,6,FBS Independents,,Navy,1944,N,N
9,2,0,7,Southern,,NC State,1944,N,N
8,6,0,2,Big 6,,Nebraska,1944,N,N
8,7,0,1,Border,,New Mexico,1944,N,N
7,5,0,2,FBS Independents,,New York University,1944,N,N
6,0,0,6,FBS Independents,,Norman Naval Air Station,1944,N,N
9,8,0,1,Southern,,North Carolina,1944,N,N
9,7,0,2,Western,,Northwestern,1944,N,N
10,2,0,8,FBS Independents,,Notre Dame,1944,N,N
9,0,0,9,Western,,Ohio State,1944,N,N
10,4,0,6,Big 6,,Oklahoma,1944,N,N
9,1,0,8,Missouri Valley,,Oklahoma State,1944,N,N
8,6,0,2,SEC,,Ole Miss,1944,N,N
9,3,0,6,FBS Independents,,Penn State,1944,N,N
9,5,0,4,FBS Independents,,Pittsburgh,1944,N,N
9,6,0,3,FBS Independents,,Presbyterian College,1944,N,N
10,5,0,5,Western,,Purdue,1944,N,N
12,0,0,12,FBS Independents,,Randolph Field,1944,N,N
11,6,0,5,Southwest,,Rice,1944,N,N
8,6,0,2,Southern,,Richmond,1944,N,N
8,4,0,4,FBS Independents,,Saint Mary's (CA) Pre-Flight,1944,N,N
8,2,0,6,FBS Independents,,Second Air Force,1944,N,N
10,5,0,5,Southwest,,SMU,1944,N,N
9,4,0,5,Southern,,South Carolina,1944,N,N
7,4,0,3,FBS Independents,,Syracuse,1944,N,N
11,4,0,7,Southwest,,TCU,1944,N,N
8,6,0,2,FBS Independents,,Temple,1944,N,N
9,2,0,7,SEC,,Tennessee,1944,N,N
9,4,0,5,Southwest,,Texas,1944,N,N
11,4,0,7,Southwest,,Texas A&M,1944,N,N
11,7,0,4,Border,,Texas Tech,1944,N,N
7,3,0,4,SEC,,Tulane,1944,N,N
10,2,0,8,Missouri Valley,,Tulsa,1944,N,N
10,5,0,5,Pacific,,UCLA,1944,N,N
10,2,0,8,Pacific,,USC,1944,N,N
8,3,0,5,Mountain State,,Utah,1944,N,N
6,3,0,3,Mountain State,,Utah State,1944,N,N
8,4,0,4,FBS Independents,,Villanova,1944,N,N
9,2,0,7,FBS Independents,,Virginia,1944,N,N
9,8,0,1,Southern,,VMI,1944,N,N
9,1,0,8,Southern,,Wake Forest,1944,N,N
8,3,0,5,Pacific,,Washington,1944,N,N
7,3,0,4,Border,,West Texas A&M,1944,N,N
9,3,0,6,FBS Independents,,West Virginia,1944,N,N
8,2,0,6,Southern,,William & Mary,1944,N,N
9,6,0,3,Western,,Wisconsin,1944,N,N
8,1,0,7,FBS Independents,,Yale,1944,N,N
10,0,0,10,SEC,,Alabama,1945,N,N
10,7,0,3,Southwest,,Arkansas,1945,N,N
9,0,0,9,FBS Independents,,Army,1945,Y,N
10,5,0,5,SEC,,Auburn,1945,N,N
11,5,0,6,Southwest,,Baylor,1945,N,N
7,4,0,3,FBS Independents,,Boston College,1945,N,N
8,5,0,3,FBS Independents,,Brown,1945,N,N
7,5,0,2,FBS Independents,,Bucknell,1945,N,N
10,6,0,4,Pacific,,California,1945,N,N
8,3,0,5,FBS Independents,,Chattanooga,1945,N,N
10,3,0,7,Southern,,Clemson,1945,N,N
8,7,0,1,FBS Independents,,Coast Guard,1945,N,N
8,4,0,4,FBS Independents,,Colgate,1945,N,N
8,3,0,5,Mountain State,,Colorado,1945,N,N
8,4,0,4,FBS Independents,,Colorado College,1945,N,N
8,5,0,3,Mountain State,,Colorado State,1945,N,N
9,1,0,8,FBS Independents,,Columbia,1945,N,N
9,4,0,5,FBS Independents,,Cornell,1945,N,N
8,6,0,2,FBS Independents,,Dartmouth,1945,N,N
10,5,0,5,Mountain State,,Denver,1945,N,N
9,3,0,6,FBS Independents,,Detroit Mercy,1945,N,N
10,5,0,5,Missouri Valley,,Drake,1945,N,N
8,2,0,6,Southern,,Duke,1945,N,N
10,5,0,5,SEC,,Florida,1945,N,N
11,2,0,9,SEC,,Georgia,1945,N,N
10,6,0,4,SEC,,Georgia Tech,1945,N,N
11,5,0,6,FBS Independents,,Great Lakes Navy,1945,N,N
8,3,0,5,FBS Independents,,Harvard,1945,N,N
10,2,0,8,FBS Independents,,Holy Cross,1945,N,N
8,7,0,1,Pacific,,Idaho,1945,N,N
9,6,0,3,Western,,Illinois,1945,N,N
10,0,0,10,Western,,Indiana,1945,N,N
9,7,0,2,Western,,Iowa,1945,N,N
8,3,0,5,Big 6,,Iowa State,1945,N,N
10,6,0,4,Big 6,,Kansas,1945,N,N
8,7,0,1,Big 6,,Kansas State,1945,N,N
10,8,0,2,SEC,,Kentucky,1945,N,N
9,7,0,2,FBS Independents,,Lafayette,1945,N,N
9,2,0,7,SEC,,LSU,1945,N,N
10,4,0,6,FBS Independents,,Marquette,1945,N,N
9,2,0,7,Southern,,Maryland,1945,N,N
8,3,0,5,FBS Independents,,Merchant Marine,1945,N,N
11,2,0,9,FBS Independents,,Miami,1945,N,N
10,3,0,7,Western,,Michigan,1945,N,N
9,4,0,5,FBS Independents,,Michigan State,1945,N,N
9,5,0,4,Western,,Minnesota,1945,N,N
9,3,0,6,SEC,,Mississippi State,1945,N,N
10,4,0,6,Big 6,,Missouri,1945,N,N
9,2,0,7,FBS Independents,,Navy,1945,N,N
9,6,0,3,Southern,,NC State,1945,N,N
9,5,0,4,Big 6,,Nebraska,1945,N,N
8,2,0,6,Border,,New Mexico,1945,N,N
7,4,0,3,FBS Independents,,New York University,1945,N,N
10,5,0,5,Southern,,North Carolina,1945,N,N
9,5,0,4,Western,,Northwestern,1945,N,N
10,2,0,8,FBS Independents,,Notre Dame,1945,N,N
9,2,0,7,Western,,Ohio State,1945,N,N
10,5,0,5,Big 6,,Oklahoma,1945,N,N
9,0,0,9,Missouri Valley,,Oklahoma State,1945,N,N
9,5,0,4,SEC,,Ole Miss,1945,N,N
9,6,0,3,Pacific,,Oregon,1945,N,N
9,5,0,4,Pacific,,Oregon State,1945,N,N
8,3,0,5,FBS Independents,,Penn State,1945,N,N
10,7,0,3,FBS Independents,,Pittsburgh,1945,N,N
7,6,0,1,FBS Independents,,Presbyterian College,1945,N,N
7,5,0,2,FBS Independents,,Princeton,1945,N,N
10,3,0,7,Western,,Purdue,1945,N,N
11,6,0,5,Southwest,,Rice,1945,N,N
8,6,0,2,Southern,,Richmond,1945,N,N
9,4,0,5,Missouri Valley,,Saint Louis,1945,N,N
8,2,0,6,FBS Independents,,Saint Mary's (CA),1945,N,N
11,6,0,5,Southwest,,SMU,1945,N,N
9,6,0,3,Southern,,South Carolina,1945,N,N
7,6,0,1,FBS Independents,,Syracuse,1945,N,N
10,5,0,5,Southwest,,TCU,1945,N,N
8,1,0,7,FBS Independents,,Temple,1945,N,N
9,1,0,8,SEC,,Tennessee,1945,N,N
11,1,0,10,Southwest,,Texas,1945,N,N
10,4,0,6,Southwest,,Texas A&M,1945,N,N
10,6,0,4,Border,,Texas Tech,1945,N,N
9,7,0,2,SEC,,Tulane,1945,N,N
11,3,0,8,Missouri Valley,,Tulsa,1945,N,N
9,4,0,5,Pacific,,UCLA,1945,N,N
11,4,0,7,Pacific,,USC,1945,N,N
8,4,0,4,Mountain State,,Utah,1945,N,N
7,3,0,4,Mountain State,,Utah State,1945,N,N
9,6,0,3,SEC,,Vanderbilt,1945,N,N
8,4,0,4,FBS Independents,,Villanova,1945,N,N
9,2,0,7,FBS Independents,,Virginia,1945,N,N
8,6,0,2,Southern,,Virginia Tech,1945,N,N
9,4,0,5,Southern,,VMI,1945,N,N
9,3,0,6,Southern,,Wake Forest,1945,N,N
9,3,0,6,Pacific,,Washington,1945,N,N
9,2,0,7,Pacific,,Washington State,1945,N,N
8,6,0,2,Border,,West Texas A&M,1945,N,N
9,7,0,2,FBS Independents,,West Virginia,1945,N,N
10,4,0,6,Missouri Valley,,Wichita State,1945,N,N
9,3,0,6,Southern,,William & Mary,1945,N,N
9,5,0,4,Western,,Wisconsin,1945,N,N
9,3,0,6,FBS Independents,,Yale,1945,N,N
11,4,0,7,SEC,,Alabama,1946,N,N
10,5,0,5,Border,,Arizona,1946,N,N
11,9,0,2,Border,,Arizona State,1946,N,N
11,4,0,7,Southwest,,Arkansas,1946,N,N
10,1,0,9,FBS Independents,,Army,1946,N,N
10,6,0,4,SEC,,Auburn,1946,N,N
9,8,0,1,Southwest,,Baylor,1946,N,N
9,3,0,6,FBS Independents,,Boston College,1946,N,N
9,6,0,3,FBS Independents,,Brown,1946,N,N
9,6,0,3,FBS Independents,,Bucknell,1946,N,N
10,4,0,6,Mountain State,,BYU,1946,N,N
9,7,0,2,Pacific,,California,1946,N,N
10,5,0,5,FBS Independents,,Chattanooga,1946,N,N
9,5,0,4,Southern,,Clemson,1946,N,N
8,4,0,4,FBS Independents,,Colgate,1946,N,N
10,5,0,5,Mountain State,,Colorado,1946,N,N
9,7,0,2,Mountain State,,Colorado State,1946,N,N
9,3,0,6,FBS Independents,,Columbia,1946,N,N
9,4,0,5,FBS Independents,,Cornell,1946,N,N
9,6,0,3,FBS Independents,,Dartmouth,1946,N,N
9,5,0,4,Southern,,Davidson,1946,N,N
11,5,0,6,Mountain State,,Denver,1946,N,N
10,4,0,6,FBS Independents,,Detroit Mercy,1946,N,N
9,6,0,3,Missouri Valley,,Drake,1946,N,N
9,5,0,4,Southern,,Duke,1946,N,N
9,9,0,0,SEC,,Florida,1946,N,N
7,7,0,0,FBS Independents,,Fordham,1946,N,N
10,8,0,2,Southern,,Furman,1946,N,N
8,3,0,5,FBS Independents,,Georgetown,1946,N,N
7,3,0,4,Southern,,George Washington,1946,N,N
11,0,0,11,SEC,,Georgia,1946,N,N
11,2,0,9,SEC,,Georgia Tech,1946,N,N
11,0,0,11,Border,,Hardin-Simmons,1946,N,N
9,2,0,7,FBS Independents,,Harvard,1946,N,N
9,4,0,5,FBS Independents,,Holy Cross,1946,N,N
9,8,0,1,Pacific,,Idaho,1946,N,N
10,2,0,8,Western,,Illinois,1946,N,N
9,3,0,6,Western,,Indiana,1946,N,N
9,4,0,5,Western,,Iowa,1946,N,N
9,7,0,2,Big 6,,Iowa State,1946,N,N
10,3,0,7,Big 6,,Kansas,1946,N,N
9,9,0,0,Big 6,,Kansas State,1946,N,N
10,3,0,7,SEC,,Kentucky,1946,N,N
9,7,0,2,FBS Independents,,Lafayette,1946,N,N
11,1,0,10,SEC,,LSU,1946,N,N
9,5,0,4,FBS Independents,,Marquette,1946,N,N
9,6,0,3,Southern,,Maryland,1946,N,N
11,7,0,4,FBS Independents,,Merchant Marine,1946,N,N
10,2,0,8,FBS Independents,,Miami,1946,N,N
9,3,0,6,Western,,Michigan,1946,N,N
10,5,0,5,FBS Independents,,Michigan State,1946,N,N
9,4,0,5,Western,,Minnesota,1946,N,N
10,2,0,8,SEC,,Mississippi State,1946,N,N
10,4,0,6,Big 6,,Missouri,1946,N,N
8,4,0,4,Pacific,,Montana,1946,N,N
10,4,0,6,FBS Independents,,Montana State,1946,N,N
9,8,0,1,FBS Independents,,Navy,1946,N,N
11,3,0,8,Southern,,NC State,1946,N,N
9,6,0,3,Big 6,,Nebraska,1946,N,N
9,2,0,7,FBS Independents,,Nevada,1946,N,N
12,6,0,6,Border,,New Mexico,1946,N,N
10,5,0,5,Border,,New Mexico State,1946,N,N
8,3,0,5,FBS Independents,,New York University,1946,N,N
11,3,0,8,Southern,,North Carolina,1946,N,N
9,2,0,7,Border,,Northern Arizona,1946,N,N
9,4,0,5,Western,,Northwestern,1946,N,N
9,0,0,9,FBS Independents,,Notre Dame,1946,Y,N
9,5,0,4,Western,,Ohio State,1946,N,N
11,3,0,8,Big 6,,Oklahoma,1946,N,N
11,8,0,3,Missouri Valley,,Oklahoma State,1946,N,N
9,7,0,2,SEC,,Ole Miss,1946,N,N
9,5,0,4,Pacific,,Oregon,1946,N,N
9,2,0,7,Pacific,,Oregon State,1946,N,N
8,2,0,6,FBS Independents,,Penn State,1946,N,N
9,6,0,3,FBS Independents,,Pittsburgh,1946,N,N
10,8,0,2,FBS Independents,,Portland,1946,N,N
8,5,0,3,FBS Independents,,Princeton,1946,N,N
9,6,0,3,Western,,Purdue,1946,N,N
11,2,0,9,Southwest,,Rice,1946,N,N
11,4,0,7,Southern,,Richmond,1946,N,N
9,2,0,7,FBS Independents,,Rutgers,1946,N,N
10,6,0,4,Missouri Valley,,Saint Louis,1946,N,N
9,3,0,6,FBS Independents,,Saint Mary's (CA),1946,N,N
9,6,0,3,FBS Independents,,San Francisco,1946,N,N
8,5,0,3,FBS Independents,,Santa Clara,1946,N,N
10,5,0,5,Southwest,,SMU,1946,N,N
8,3,0,5,Southern,,South Carolina,1946,N,N
10,3,0,7,Pacific,,Stanford,1946,N,N
9,5,0,4,FBS Independents,,Syracuse,1946,N,N
10,7,0,3,Southwest,,TCU,1946,N,N
8,5,0,3,FBS Independents,,Temple,1946,N,N
11,2,0,9,SEC,,Tennessee,1946,N,N
10,2,0,8,Southwest,,Texas,1946,N,N
10,6,0,4,Southwest,,Texas A&M,1946,N,N
11,3,0,8,Border,,Texas Tech,1946,N,N
8,5,0,3,Southern,,The Citadel,1946,N,N
10,7,0,3,SEC,,Tulane,1946,N,N
10,1,0,9,Missouri Valley,,Tulsa,1946,N,N
11,1,0,10,Pacific,,UCLA,1946,N,N
10,4,0,6,Pacific,,USC,1946,N,N
11,3,0,8,Mountain State,,Utah,1946,N,N
10,3,0,7,Mountain State,,Utah State,1946,N,N
9,6,0,3,Border,,UTEP,1946,N,N
9,4,0,5,SEC,,Vanderbilt,1946,N,N
10,4,0,6,FBS Independents,,Villanova,1946,N,N
9,5,0,4,FBS Independents,,Virginia,1946,N,N
10,4,0,6,Southern,,Virginia Tech,1946,N,N
10,5,0,5,Southern,,VMI,1946,N,N
9,3,0,6,Southern,,Wake Forest,1946,N,N
9,4,0,5,Pacific,,Washington,1946,N,N
8,6,0,2,Southern,,Washington & Lee,1946,N,N
8,6,0,2,Pacific,,Washington State,1946,N,N
10,5,0,5,Border,,West Texas A&M,1946,N,N
10,5,0,5,FBS Independents,,West Virginia,1946,N,N
10,5,0,5,Missouri Valley,,Wichita State,1946,N,N
10,2,0,8,Southern,,William & Mary,1946,N,N
9,5,0,4,Western,,Wisconsin,1946,N,N
10,9,0,1,Mountain State,,Wyoming,1946,N,N
9,1,0,8,FBS Independents,,Yale,1946,N,N
11,3,0,8,SEC,,Alabama,1947,N,N
10,5,0,5,Border,,Arizona,1947,N,N
11,7,0,4,Border,,Arizona State,1947,N,N
11,5,0,6,Southwest,,Arkansas,1947,N,N
9,3,0,6,FBS Independents,,Army,1947,N,N
9,7,0,2,SEC,,Auburn,1947,N,N
10,5,0,5,Southwest,,Baylor,1947,N,N
9,4,0,5,FBS Independents,,Boston College,1947,N,N
8,3,0,5,FBS Independents,,Boston University,1947,N,N
9,4,0,5,FBS Independents,,Brown,1947,N,N
10,7,0,3,Mountain State,,BYU,1947,N,N
10,1,0,9,Pacific,,California,1947,N,N
10,6,0,4,FBS Independents,,Chattanooga,1947,N,N
9,5,0,4,Southern,,Clemson,1947,N,N
8,6,0,2,FBS Independents,,Colgate,1947,N,N
9,5,0,4,Mountain State,,Colorado,1947,N,N
10,4,0,6,Mountain State,,Colorado State,1947,N,N
9,2,0,7,FBS Independents,,Columbia,1947,N,N
9,5,0,4,FBS Independents,,Cornell,1947,N,N
9,4,0,5,FBS Independents,,Dartmouth,1947,N,N
10,4,0,6,Southern,,Davidson,1947,N,N
10,5,0,5,Mountain State,,Denver,1947,N,N
10,4,0,6,FBS Independents,,Detroit Mercy,1947,N,N
9,8,0,1,Missouri Valley,,Drake,1947,N,N
9,4,0,5,Southern,,Duke,1947,N,N
10,8,0,2,FBS Independents,,Duquesne,1947,N,N
10,5,0,5,SEC,,Florida,1947,N,N
8,7,0,1,FBS Independents,,Fordham,1947,N,N
9,7,0,2,Southern,,Furman,1947,N,N
8,5,0,3,FBS Independents,,Georgetown,1947,N,N
9,7,0,2,Southern,,George Washington,1947,N,N
12,5,0,7,SEC,,Georgia,1947,N,N
11,1,0,10,SEC,,Georgia Tech,1947,N,N
11,3,0,8,Border,,Hardin-Simmons,1947,N,N
9,5,0,4,FBS Independents,,Harvard,1947,N,N
10,6,0,4,FBS Independents,,Holy Cross,1947,N,N
8,4,0,4,Pacific,,Idaho,1947,N,N
9,3,0,6,Western,,Illinois,1947,N,N
9,4,0,5,Western,,Indiana,1947,N,N
9,5,0,4,Western,,Iowa,1947,N,N
9,6,0,3,Big 6,,Iowa State,1947,N,N
11,2,0,9,Big 6,,Kansas,1947,N,N
10,10,0,0,Big 6,,Kansas State,1947,N,N
11,3,0,8,SEC,,Kentucky,1947,N,N
9,3,0,6,SEC,,LSU,1947,N,N
9,5,0,4,FBS Independents,,Marquette,1947,N,N
11,3,0,8,Southern,,Maryland,1947,N,N
11,9,0,2,FBS Independents,,Merchant Marine,1947,N,N
10,7,0,3,FBS Independents,,Miami,1947,N,N
10,0,0,10,Western,,Michigan,1947,N,N
9,2,0,7,FBS Independents,,Michigan State,1947,N,N
9,3,0,6,Western,,Minnesota,1947,N,N
10,3,0,7,SEC,,Mississippi State,1947,N,N
10,4,0,6,Big 6,,Missouri,1947,N,N
11,4,0,7,Pacific,,Montana,1947,N,N
9,5,0,4,FBS Independents,,Montana State,1947,N,N
9,8,0,1,FBS Independents,,Navy,1947,N,N
9,3,0,6,Southern,,NC State,1947,N,N
9,7,0,2,Big 6,,Nebraska,1947,N,N
11,2,0,9,FBS Independents,,Nevada,1947,N,N
10,5,0,5,Border,,New Mexico,1947,N,N
9,6,0,3,Border,,New Mexico State,1947,N,N
8,5,0,3,FBS Independents,,New York University,1947,N,N
10,2,0,8,Southern,,North Carolina,1947,N,N
8,7,0,1,Border,,Northern Arizona,1947,N,N
9,6,0,3,Western,,Northwestern,1947,N,N
9,0,0,9,FBS Independents,,Notre Dame,1947,Y,N
9,7,0,2,Western,,Ohio State,1947,N,N
10,3,0,7,Big 6,,Oklahoma,1947,N,N
10,7,0,3,Missouri Valley,,Oklahoma State,1947,N,N
11,2,0,9,SEC,,Ole Miss,1947,N,N
10,3,0,7,Pacific,,Oregon,1947,N,N
10,5,0,5,Pacific,,Oregon State,1947,N,N
10,0,0,10,FBS Independents,,Penn State,1947,N,N
9,8,0,1,FBS Independents,,Pittsburgh,1947,N,N
9,8,0,1,FBS Independents,,Portland,1947,N,N
8,3,0,5,FBS Independents,,Princeton,1947,N,N
9,4,0,5,Western,,Purdue,1947,N,N
10,3,0,7,Southwest,,Rice,1947,N,N
10,7,0,3,Southern,,Richmond,1947,N,N
9,1,0,8,FBS Independents,,Rutgers,1947,N,N
10,6,0,4,Missouri Valley,,Saint Louis,1947,N,N
10,7,0,3,FBS Independents,,Saint Mary's (CA),1947,N,N
10,3,0,7,FBS Independents,,San Francisco,1947,N,N
8,4,0,4,FBS Independents,,Santa Clara,1947,N,N
11,1,0,10,Southwest,,SMU,1947,N,N
9,2,0,7,Southern,,South Carolina,1947,N,N
9,9,0,0,Pacific,,Stanford,1947,N,N
9,6,0,3,FBS Independents,,Syracuse,1947,N,N
11,6,0,5,Southwest,,TCU,1947,N,N
9,6,0,3,FBS Independents,,Temple,1947,N,N
10,5,0,5,SEC,,Tennessee,1947,N,N
11,1,0,10,Southwest,,Texas,1947,N,N
10,6,0,4,Southwest,,Texas A&M,1947,N,N
11,5,0,6,Border,,Texas Tech,1947,N,N
8,5,0,3,Southern,,The Citadel,1947,N,N
9,7,0,2,SEC,,Tulane,1947,N,N
10,5,0,5,Missouri Valley,,Tulsa,1947,N,N
9,4,0,5,Pacific,,UCLA,1947,N,N
10,3,0,7,Pacific,,USC,1947,N,N
10,1,0,9,Mountain State,,Utah,1947,N,N
11,5,0,6,Mountain State,,Utah State,1947,N,N
9,4,0,5,Border,,UTEP,1947,N,N
10,4,0,6,SEC,,Vanderbilt,1947,N,N
10,4,0,6,FBS Independents,,Villanova,1947,N,N
10,3,0,7,FBS Independents,,Virginia,1947,N,N
9,5,0,4,Southern,,Virginia Tech,1947,N,N
9,5,0,4,Southern,,VMI,1947,N,N
10,4,0,6,Southern,,Wake Forest,1947,N,N
9,6,0,3,Pacific,,Washington,1947,N,N
10,5,0,5,Southern,,Washington & Lee,1947,N,N
10,7,0,3,Pacific,,Washington State,1947,N,N
11,4,0,7,Border,,West Texas A&M,1947,N,N
10,4,0,6,FBS Independents,,West Virginia,1947,N,N
11,4,0,7,Missouri Valley,,Wichita State,1947,N,N
11,2,0,9,Southern,,William & Mary,1947,N,N
9,3,0,6,Western,,Wisconsin,1947,N,N
9,5,0,4,Mountain State,,Wyoming,1947,N,N
9,3,0,6,FBS Independents,,Yale,1947,N,N
11,5,0,6,SEC,,Alabama,1948,N,N
11,5,0,6,Border,,Arizona,1948,N,N
10,5,0,5,Border,,Arizona State,1948,N,N
10,5,0,5,Southwest,,Arkansas,1948,N,N
9,1,0,8,FBS Independents,,Army,1948,N,N
10,9,0,1,SEC,,Auburn,1948,N,N
11,4,0,7,Southwest,,Baylor,1948,N,N
9,4,0,5,FBS Independents,,Boston College,1948,N,N
8,2,0,6,FBS Independents,,Boston University,1948,N,N
9,2,0,7,FBS Independents,,Brown,1948,N,N
11,6,0,5,Skyline,,BYU,1948,N,N
11,1,0,10,Pacific,,California,1948,N,N
9,5,0,4,FBS Independents,,Chattanooga,1948,N,N
11,0,0,11,Southern,,Clemson,1948,N,N
9,6,0,3,FBS Independents,,Colgate,1948,N,N
9,6,0,3,Big 7,,Colorado,1948,N,N
11,3,0,8,Skyline,,Colorado State,1948,N,N
9,5,0,4,FBS Independents,,Columbia,1948,N,N
9,1,0,8,FBS Independents,,Cornell,1948,N,N
8,2,0,6,FBS Independents,,Dartmouth,1948,N,N
9,5,0,4,Southern,,Davidson,1948,N,N
10,5,0,5,Skyline,,Denver,1948,N,N
9,3,0,6,FBS Independents,,Detroit Mercy,1948,N,N
10,3,0,7,Missouri Valley,,Drake,1948,N,N
9,4,0,5,Southern,,Duke,1948,N,N
9,7,0,2,FBS Independents,,Duquesne,1948,N,N
10,5,0,5,SEC,,Florida,1948,N,N
9,6,0,3,FBS Independents,,Fordham,1948,N,N
9,7,0,2,Southern,,Furman,1948,N,N
8,5,0,3,FBS Independents,,Georgetown,1948,N,N
10,6,0,4,Southern,,George Washington,1948,N,N
11,2,0,9,SEC,,Georgia,1948,N,N
10,3,0,7,SEC,,Georgia Tech,1948,N,N
11,2,0,9,Border,,Hardin-Simmons,1948,N,N
8,4,0,4,FBS Independents,,Harvard,1948,N,N
10,5,0,5,FBS Independents,,Holy Cross,1948,N,N
9,6,0,3,Pacific,,Idaho,1948,N,N
9,6,0,3,Western,,Illinois,1948,N,N
9,7,0,2,Western,,Indiana,1948,N,N
9,5,0,4,Western,,Iowa,1948,N,N
10,6,0,4,Big 7,,Iowa State,1948,N,N
10,3,0,7,Big 7,,Kansas,1948,N,N
10,9,0,1,Big 7,,Kansas State,1948,N,N
10,4,0,6,SEC,,Kentucky,1948,N,N
10,7,0,3,SEC,,LSU,1948,N,N
10,8,0,2,FBS Independents,,Marquette,1948,N,N
10,4,0,6,Southern,,Maryland,1948,N,N
10,6,0,4,FBS Independents,,Miami,1948,N,N
9,0,0,9,Western,,Michigan,1948,Y,N
10,2,0,8,FBS Independents,,Michigan State,1948,N,N
9,2,0,7,Western,,Minnesota,1948,N,N
9,5,0,4,SEC,,Mississippi State,1948,N,N
11,3,0,8,Big 7,,Missouri,1948,N,N
10,7,0,3,Pacific,,Montana,1948,N,N
9,8,0,1,FBS Independents,,Navy,1948,N,N
10,7,0,3,Southern,,NC State,1948,N,N
10,8,0,2,Big 7,,Nebraska,1948,N,N
11,2,0,9,FBS Independents,,Nevada,1948,N,N
11,9,0,2,Border,,New Mexico,1948,N,N
10,7,0,3,Border,,New Mexico State,1948,N,N
9,6,0,3,FBS Independents,,New York University,1948,N,N
11,2,0,9,Southern,,North Carolina,1948,N,N
9,5,0,4,Border,,Northern Arizona,1948,N,N
10,2,0,8,Western,,Northwestern,1948,N,N
10,0,0,10,FBS Independents,,Notre Dame,1948,N,N
9,3,0,6,Western,,Ohio State,1948,N,N
11,1,0,10,Big 7,,Oklahoma,1948,N,N
10,4,0,6,Missouri Valley,,Oklahoma State,1948,N,N
9,1,0,8,SEC,,Ole Miss,1948,N,N
11,2,0,9,Pacific,,Oregon,1948,N,N
12,6,0,6,Pacific,,Oregon State,1948,N,N
9,2,0,7,FBS Independents,,Penn State,1948,N,N
9,3,0,6,FBS Independents,,Pittsburgh,1948,N,N
8,4,0,4,FBS Independents,,Princeton,1948,N,N
9,6,0,3,Western,,Purdue,1948,N,N
10,4,0,6,Southwest,,Rice,1948,N,N
10,4,0,6,Southern,,Richmond,1948,N,N
9,2,0,7,FBS Independents,,Rutgers,1948,N,N
11,7,0,4,Missouri Valley,,Saint Louis,1948,N,N
10,6,0,4,FBS Independents,,Saint Mary's (CA),1948,N,N
9,7,0,2,FBS Independents,,San Francisco,1948,N,N
10,3,0,7,FBS Independents,,Santa Clara,1948,N,N
11,2,0,9,Southwest,,SMU,1948,N,N
8,5,0,3,Southern,,South Carolina,1948,N,N
10,6,0,4,Pacific,,Stanford,1948,N,N
9,8,0,1,FBS Independents,,Syracuse,1948,N,N
10,5,0,5,Southwest,,TCU,1948,N,N
9,7,0,2,FBS Independents,,Temple,1948,N,N
10,5,0,5,SEC,,Tennessee,1948,N,N
11,4,0,7,Southwest,,Texas,1948,N,N
10,9,0,1,Southwest,,Texas A&M,1948,N,N
10,3,0,7,Border,,Texas Tech,1948,N,N
9,7,0,2,Southern,,The Citadel,1948,N,N
10,1,0,9,SEC,,Tulane,1948,N,N
10,9,0,1,Missouri Valley,,Tulsa,1948,N,N
10,7,0,3,Pacific,,UCLA,1948,N,N
10,4,0,6,Pacific,,USC,1948,N,N
10,1,0,9,Skyline,,Utah,1948,N,N
11,6,0,5,Skyline,,Utah State,1948,N,N
11,3,0,8,Border,,UTEP,1948,N,N
11,2,0,9,SEC,,Vanderbilt,1948,N,N
11,2,0,9,FBS Independents,,Villanova,1948,N,N
9,4,0,5,FBS Independents,,Virginia,1948,N,N
9,8,0,1,Southern,,Virginia Tech,1948,N,N
9,3,0,6,Southern,,VMI,1948,N,N
10,4,0,6,Southern,,Wake Forest,1948,N,N
10,7,0,3,Pacific,,Washington,1948,N,N
10,6,0,4,Southern,,Washington & Lee,1948,N,N
10,6,0,4,Pacific,,Washington State,1948,N,N
11,5,0,6,Border,,West Texas A&M,1948,N,N
12,3,0,9,FBS Independents,,West Virginia,1948,N,N
10,5,0,5,Missouri Valley,,Wichita State,1948,N,N
11,2,0,9,Southern,,William & Mary,1948,N,N
9,7,0,2,Western,,Wisconsin,1948,N,N
9,5,0,4,Skyline,,Wyoming,1948,N,N
9,5,0,4,FBS Independents,,Yale,1948,N,N
10,4,0,6,SEC,,Alabama,1949,N,N
10,8,0,2,Border,,Arizona,1949,N,N
10,3,0,7,Border,,Arizona State,1949,N,N
10,5,0,5,Southwest,,Arkansas,1949,N,N
9,0,0,9,FBS Independents,,Army,1949,N,N
9,7,0,2,SEC,,Auburn,1949,N,N
10,2,0,8,Southwest,,Baylor,1949,N,N
9,5,0,4,FBS Independents,,Boston College,1949,N,N
8,2,0,6,FBS Independents,,Boston University,1949,N,N
10,5,0,5,Missouri Valley,,Bradley,1949,N,N
9,1,0,8,FBS Independents,,Brown,1949,N,N
11,11,0,0,Skyline,,BYU,1949,N,N
11,1,0,10,Pacific,,California,1949,N,N
10,5,0,5,Southern,,Clemson,1949,N,N
9,8,0,1,FBS Independents,,Colgate,1949,N,N
10,7,0,3,Big 7,,Colorado,1949,N,N
10,1,0,9,Skyline,,Colorado State,1949,N,N
9,7,0,2,FBS Independents,,Columbia,1949,N,N
9,1,0,8,FBS Independents,,Cornell,1949,N,N
8,2,0,6,FBS Independents,,Dartmouth,1949,N,N
10,8,0,2,Southern,,Davidson,1949,N,N
10,6,0,4,Skyline,,Denver,1949,N,N
9,4,0,5,Missouri Valley,,Detroit Mercy,1949,N,N
9,2,0,7,Missouri Valley,,Drake,1949,N,N
9,3,0,6,Southern,,Duke,1949,N,N
9,6,0,3,FBS Independents,,Duquesne,1949,N,N
10,5,0,5,SEC,,Florida,1949,N,N
8,3,0,5,FBS Independents,,Fordham,1949,N,N
9,6,0,3,Southern,,Furman,1949,N,N
10,5,0,5,FBS Independents,,Georgetown,1949,N,N
9,5,0,4,Southern,,George Washington,1949,N,N
11,6,0,5,SEC,,Georgia,1949,N,N
10,3,0,7,SEC,,Georgia Tech,1949,N,N
11,4,0,7,Border,,Hardin-Simmons,1949,N,N
9,8,0,1,FBS Independents,,Harvard,1949,N,N
10,9,0,1,FBS Independents,,Holy Cross,1949,N,N
10,5,0,5,FBS Independents,,Houston,1949,N,N
8,5,0,3,Pacific,,Idaho,1949,N,N
9,6,0,3,Western,,Illinois,1949,N,N
9,8,0,1,Western,,Indiana,1949,N,N
9,5,0,4,Western,,Iowa,1949,N,N
9,3,0,6,Big 7,,Iowa State,1949,N,N
10,5,0,5,Big 7,,Kansas,1949,N,N
10,8,0,2,Big 7,,Kansas State,1949,N,N
12,3,0,9,SEC,,Kentucky,1949,N,N
10,4,0,6,FBS Independents,,Loyola Marymount,1949,N,N
11,3,0,8,SEC,,LSU,1949,N,N
9,5,0,4,FBS Independents,,Marquette,1949,N,N
10,1,0,9,Southern,,Maryland,1949,N,N
9,3,0,6,FBS Independents,,Miami,1949,N,N
9,3,0,6,Western,,Michigan,1949,N,N
9,3,0,6,FBS Independents,,Michigan State,1949,N,N
9,2,0,7,Western,,Minnesota,1949,N,N
9,8,0,1,SEC,,Mississippi State,1949,N,N
11,4,0,7,Big 7,,Missouri,1949,N,N
9,4,0,5,Pacific,,Montana,1949,N,N
9,5,0,4,FBS Independents,,Navy,1949,N,N
10,7,0,3,Southern,,NC State,1949,N,N
9,5,0,4,Big 7,,Nebraska,1949,N,N
10,5,0,5,FBS Independents,,Nevada,1949,N,N
10,8,0,2,Border,,New Mexico,1949,N,N
10,6,0,4,Border,,New Mexico State,1949,N,N
9,6,0,3,FBS Independents,,New York University,1949,N,N
11,4,0,7,Southern,,North Carolina,1949,N,N
8,6,0,2,Border,,Northern Arizona,1949,N,N
9,5,0,4,Western,,Northwestern,1949,N,N
10,0,0,10,FBS Independents,,Notre Dame,1949,Y,N
10,1,0,9,Western,,Ohio State,1949,N,N
11,0,0,11,Big 7,,Oklahoma,1949,N,N
10,5,0,5,Missouri Valley,,Oklahoma State,1949,N,N
10,5,0,5,SEC,,Ole Miss,1949,N,N
10,6,0,4,Pacific,,Oregon,1949,N,N
10,3,0,7,Pacific,,Oregon State,1949,N,N
9,4,0,5,FBS Independents,,Penn State,1949,N,N
9,3,0,6,FBS Independents,,Pittsburgh,1949,N,N
9,3,0,6,FBS Independents,,Princeton,1949,N,N
9,5,0,4,Western,,Purdue,1949,N,N
11,1,0,10,Southwest,,Rice,1949,N,N
10,7,0,3,Southern,,Richmond,1949,N,N
9,3,0,6,FBS Independents,,Rutgers,1949,N,N
9,7,0,2,Missouri Valley,,Saint Louis,1949,N,N
10,7,0,3,FBS Independents,,Saint Mary's (CA),1949,N,N
10,3,0,7,FBS Independents,,San Francisco,1949,N,N
11,2,0,9,FBS Independents,,Santa Clara,1949,N,N
10,4,0,6,Southwest,,SMU,1949,N,N
10,6,0,4,Southern,,South Carolina,1949,N,N
11,4,0,7,Pacific,,Stanford,1949,N,N
9,5,0,4,FBS Independents,,Syracuse,1949,N,N
10,4,0,6,Southwest,,TCU,1949,N,N
9,4,0,5,FBS Independents,,Temple,1949,N,N
10,2,0,8,SEC,,Tennessee,1949,N,N
10,4,0,6,Southwest,,Texas,1949,N,N
10,9,0,1,Southwest,,Texas A&M,1949,N,N
12,5,0,7,Border,,Texas Tech,1949,N,N
9,5,0,4,Southern,,The Citadel,1949,N,N
10,3,0,7,SEC,,Tulane,1949,N,N
11,5,0,6,Missouri Valley,,Tulsa,1949,N,N
9,3,0,6,Pacific,,UCLA,1949,N,N
9,4,0,5,Pacific,,USC,1949,N,N
10,7,0,3,Skyline,,Utah,1949,N,N
10,7,0,3,Skyline,,Utah State,1949,N,N
11,2,0,9,Border,,UTEP,1949,N,N
10,5,0,5,SEC,,Vanderbilt,1949,N,N
9,1,0,8,FBS Independents,,Villanova,1949,N,N
9,2,0,7,FBS Independents,,Virginia,1949,N,N
10,8,0,2,Southern,,Virginia Tech,1949,N,N
9,6,0,3,Southern,,VMI,1949,N,N
10,6,0,4,Southern,,Wake Forest,1949,N,N
10,7,0,3,Pacific,,Washington,1949,N,N
9,5,0,4,Southern,,Washington & Lee,1949,N,N
9,6,0,3,Pacific,,Washington State,1949,N,N
9,4,0,5,Border,,West Texas A&M,1949,N,N
11,7,0,4,FBS Independents,,West Virginia,1949,N,N
10,6,0,4,Missouri Valley,,Wichita State,1949,N,N
10,4,0,6,Southern,,William & Mary,1949,N,N
9,3,0,6,Western,,Wisconsin,1949,N,N
10,1,0,9,Skyline,,Wyoming,1949,N,N
8,4,0,4,FBS Independents,,Yale,1949,N,N
11,2,0,9,SEC,,Alabama,1950,N,N
10,6,0,4,Border,,Arizona,1950,N,N
11,2,0,9,Border,,Arizona State,1950,N,N
10,8,0,2,Southwest,,Arkansas,1950,N,N
9,1,0,8,FBS Independents,,Army,1950,N,N
10,10,0,0,SEC,,Auburn,1950,N,N
10,3,0,7,Southwest,,Baylor,1950,N,N
10,10,0,0,FBS Independents,,Boston College,1950,N,N
8,5,0,3,FBS Independents,,Boston University,1950,N,N
10,5,0,5,Missouri Valley,,Bradley,1950,N,N
9,8,0,1,FBS Independents,,Brown,1950,N,N
10,6,0,4,Skyline,,BYU,1950,N,N
11,2,0,9,Pacific,,California,1950,N,N
10,0,0,10,Southern,,Clemson,1950,N,N
8,3,0,5,FBS Independents,,Colgate,1950,N,N
10,4,0,6,Big 7,,Colorado,1950,N,N
9,3,0,6,Skyline,,Colorado State,1950,N,N
9,5,0,4,FBS Independents,,Columbia,1950,N,N
9,2,0,7,FBS Independents,,Cornell,1950,N,N
9,6,0,3,FBS Independents,,Dartmouth,1950,N,N
9,6,0,3,Southern,,Davidson,1950,N,N
12,9,0,3,Skyline,,Denver,1950,N,N
10,3,0,7,Missouri Valley,,Detroit Mercy,1950,N,N
9,3,0,6,Missouri Valley,,Drake,1950,N,N
10,3,0,7,Southern,,Duke,1950,N,N
9,6,0,3,FBS Independents,,Duquesne,1950,N,N
10,5,0,5,SEC,,Florida,1950,N,N
9,1,0,8,FBS Independents,,Fordham,1950,N,N
11,9,0,2,Southern,,Furman,1950,N,N
9,7,0,2,FBS Independents,,Georgetown,1950,N,N
9,4,0,5,Southern,,George Washington,1950,N,N
12,4,0,8,SEC,,Georgia,1950,N,N
11,6,0,5,SEC,,Georgia Tech,1950,N,N
10,5,0,5,Border,,Hardin-Simmons,1950,N,N
8,7,0,1,FBS Independents,,Harvard,1950,N,N
10,5,0,5,FBS Independents,,Holy Cross,1950,N,N
10,6,0,4,FBS Independents,,Houston,1950,N,N
9,5,0,4,Pacific,,Idaho,1950,N,N
9,2,0,7,Western,,Illinois,1950,N,N
9,5,0,4,Western,,Indiana,1950,N,N
9,6,0,3,Western,,Iowa,1950,N,N
10,6,0,4,Big 7,,Iowa State,1950,N,N
10,4,0,6,Big 7,,Kansas,1950,N,N
11,9,0,2,Big 7,,Kansas State,1950,N,N
12,1,0,11,SEC,,Kentucky,1950,N,N
9,1,0,8,FBS Independents,,Loyola Marymount,1950,N,N
11,6,0,5,SEC,,LSU,1950,N,N
9,3,0,6,FBS Independents,,Marquette,1950,N,N
10,2,0,8,Southern,,Maryland,1950,N,N
11,2,0,9,FBS Independents,,Miami,1950,N,N
10,3,0,7,Western,,Michigan,1950,N,N
9,1,0,8,FBS Independents,,Michigan State,1950,N,N
9,8,0,1,Western,,Minnesota,1950,N,N
9,5,0,4,SEC,,Mississippi State,1950,N,N
10,6,0,4,Big 7,,Missouri,1950,N,N
10,5,0,5,FBS Independents,,Montana,1950,N,N
9,6,0,3,FBS Independents,,Navy,1950,N,N
10,4,0,6,Southern,,NC State,1950,N,N
9,3,0,6,Big 7,,Nebraska,1950,N,N
10,9,0,1,FBS Independents,,Nevada,1950,N,N
10,8,0,2,Border,,New Mexico,1950,N,N
9,7,0,2,Border,,New Mexico State,1950,N,N
7,5,0,2,FBS Independents,,New York University,1950,N,N
10,6,0,4,Southern,,North Carolina,1950,N,N
9,7,0,2,Border,,Northern Arizona,1950,N,N
9,3,0,6,Western,,Northwestern,1950,N,N
9,4,0,5,FBS Independents,,Notre Dame,1950,N,N
9,3,0,6,Western,,Ohio State,1950,N,N
11,1,0,10,Big 7,,Oklahoma,1950,Y,N
11,6,0,5,Missouri Valley,,Oklahoma State,1950,N,N
10,5,0,5,SEC,,Ole Miss,1950,N,N
10,9,0,1,Pacific,,Oregon,1950,N,N
9,6,0,3,Pacific,,Oregon State,1950,N,N
11,4,0,7,FBS Independents,,Pacific,1950,N,N
9,4,0,5,FBS Independents,,Penn State,1950,N,N
9,8,0,1,FBS Independents,,Pittsburgh,1950,N,N
9,0,0,9,FBS Independents,,Princeton,1950,N,N
9,7,0,2,Western,,Purdue,1950,N,N
10,4,0,6,Southwest,,Rice,1950,N,N
10,8,0,2,Southern,,Richmond,1950,N,N
8,4,0,4,FBS Independents,,Rutgers,1950,N,N
10,8,0,2,FBS Independents,,Saint Mary's (CA),1950,N,N
11,4,0,7,FBS Independents,,San Francisco,1950,N,N
10,3,0,7,FBS Independents,,San Josï¿½ State,1950,N,N
10,7,0,3,FBS Independents,,Santa Clara,1950,N,N
10,4,0,6,Southwest,,SMU,1950,N,N
9,6,0,3,Southern,,South Carolina,1950,N,N
10,4,0,6,Pacific,,Stanford,1950,N,N
10,5,0,5,FBS Independents,,Syracuse,1950,N,N
10,5,0,5,Southwest,,TCU,1950,N,N
9,4,0,5,FBS Independents,,Temple,1950,N,N
12,1,0,11,SEC,,Tennessee,1950,N,N
11,2,0,9,Southwest,,Texas,1950,N,N
11,4,0,7,Southwest,,Texas A&M,1950,N,N
11,8,0,3,Border,,Texas Tech,1950,N,N
10,6,0,4,Southern,,The Citadel,1950,N,N
9,3,0,6,SEC,,Tulane,1950,N,N
11,2,0,9,Missouri Valley,,Tulsa,1950,N,N
9,3,0,6,Pacific,,UCLA,1950,N,N
9,5,0,4,Pacific,,USC,1950,N,N
10,5,0,5,Skyline,,Utah,1950,N,N
11,9,0,2,Skyline,,Utah State,1950,N,N
10,3,0,7,Border,,UTEP,1950,N,N
11,4,0,7,SEC,,Vanderbilt,1950,N,N
9,5,0,4,FBS Independents,,Villanova,1950,N,N
10,2,0,8,FBS Independents,,Virginia,1950,N,N
10,10,0,0,Southern,,Virginia Tech,1950,N,N
10,4,0,6,Southern,,VMI,1950,N,N
9,2,0,7,Southern,,Wake Forest,1950,N,N
10,2,0,8,Pacific,,Washington,1950,N,N
11,3,0,8,Southern,,Washington & Lee,1950,N,N
9,5,0,4,Pacific,,Washington State,1950,N,N
11,1,0,10,Border,,West Texas A&M,1950,N,N
10,8,0,2,Southern,,West Virginia,1950,N,N
10,5,0,5,Missouri Valley,,Wichita State,1950,N,N
11,7,0,4,Southern,,William & Mary,1950,N,N
9,3,0,6,Western,,Wisconsin,1950,N,N
10,0,0,10,Skyline,,Wyoming,1950,N,N
9,3,0,6,FBS Independents,,Yale,1950,N,N
11,6,0,5,SEC,,Alabama,1951,N,N
11,5,0,6,Border,,Arizona,1951,N,N
10,3,0,7,Border,,Arizona State,1951,N,N
10,5,0,5,Southwest,,Arkansas,1951,N,N
9,7,0,2,FBS Independents,,Army,1951,N,N
10,5,0,5,SEC,,Auburn,1951,N,N
11,2,0,9,Southwest,,Baylor,1951,N,N
9,6,0,3,FBS Independents,,Boston College,1951,N,N
10,4,0,6,FBS Independents,,Boston University,1951,N,N
9,5,0,4,Missouri Valley,,Bradley,1951,N,N
9,7,0,2,FBS Independents,,Brown,1951,N,N
10,3,0,7,Skyline,,BYU,1951,N,N
10,2,0,8,Pacific,,California,1951,N,N
10,3,0,7,Southern,,Clemson,1951,N,N
9,5,0,4,FBS Independents,,Colgate,1951,N,N
10,3,0,7,Big 7,,Colorado,1951,N,N
10,5,0,5,Skyline,,Colorado State,1951,N,N
8,3,0,5,FBS Independents,,Columbia,1951,N,N
9,3,0,6,FBS Independents,,Cornell,1951,N,N
9,5,0,4,FBS Independents,,Dartmouth,1951,N,N
9,8,0,1,Southern,,Davidson,1951,N,N
10,4,0,6,Skyline,,Denver,1951,N,N
11,7,0,4,Missouri Valley,,Detroit Mercy,1951,N,N
9,2,0,7,Missouri Valley,,Drake,1951,N,N
10,4,0,6,Southern,,Duke,1951,N,N
10,5,0,5,SEC,,Florida,1951,N,N
9,4,0,5,FBS Independents,,Fordham,1951,N,N
10,6,0,4,Southern,,Furman,1951,N,N
9,7,0,2,Southern,,George Washington,1951,N,N
10,5,0,5,SEC,,Georgia,1951,N,N
12,1,0,11,SEC,,Georgia Tech,1951,N,N
12,6,0,6,Border,,Hardin-Simmons,1951,N,N
9,5,0,4,FBS Independents,,Harvard,1951,N,N
10,2,0,8,FBS Independents,,Holy Cross,1951,N,N
11,5,0,6,Missouri Valley,,Houston,1951,N,N
9,7,0,2,Pacific,,Idaho,1951,N,N
10,0,0,10,Western,,Illinois,1951,N,N
9,7,0,2,Western,,Indiana,1951,N,N
9,6,0,3,Western,,Iowa,1951,N,N
9,4,0,5,Big 7,,Iowa State,1951,N,N
10,2,0,8,Big 7,,Kansas,1951,N,N
9,8,0,1,Big 7,,Kansas State,1951,N,N
12,4,0,8,SEC,,Kentucky,1951,N,N
9,6,0,3,FBS Independents,,Loyola Marymount,1951,N,N
11,4,0,7,SEC,,LSU,1951,N,N
11,7,0,4,FBS Independents,,Marquette,1951,N,N
10,0,0,10,Southern,,Maryland,1951,N,N
11,3,0,8,FBS Independents,,Miami,1951,N,N
9,5,0,4,Western,,Michigan,1951,N,N
9,0,0,9,FBS Independents,,Michigan State,1951,N,N
9,6,0,3,Western,,Minnesota,1951,N,N
9,5,0,4,SEC,,Mississippi State,1951,N,N
10,8,0,2,Big 7,,Missouri,1951,N,N
9,7,0,2,Skyline,,Montana,1951,N,N
9,6,0,3,FBS Independents,,Navy,1951,N,N
10,7,0,3,Southern,,NC State,1951,N,N
10,8,0,2,Big 7,,Nebraska,1951,N,N
11,7,0,4,Skyline,,New Mexico,1951,N,N
10,9,0,1,Border,,New Mexico State,1951,N,N
8,7,0,1,FBS Independents,,New York University,1951,N,N
10,8,0,2,Southern,,North Carolina,1951,N,N
8,7,0,1,Border,,Northern Arizona,1951,N,N
9,4,0,5,Western,,Northwestern,1951,N,N
10,3,0,7,FBS Independents,,Notre Dame,1951,N,N
9,4,0,5,Western,,Ohio State,1951,N,N
10,2,0,8,Big 7,,Oklahoma,1951,Y,N
10,7,0,3,Missouri Valley,,Oklahoma State,1951,N,N
10,3,0,7,SEC,,Ole Miss,1951,N,N
10,8,0,2,Pacific,,Oregon,1951,N,N
10,6,0,4,Pacific,,Oregon State,1951,N,N
11,5,0,6,FBS Independents,,Pacific,1951,N,N
9,4,0,5,FBS Independents,,Penn State,1951,N,N
10,7,0,3,FBS Independents,,Pittsburgh,1951,N,N
9,0,0,9,FBS Independents,,Princeton,1951,N,N
9,4,0,5,Western,,Purdue,1951,N,N
10,5,0,5,Southwest,,Rice,1951,N,N
11,8,0,3,Southern,,Richmond,1951,N,N
8,4,0,4,FBS Independents,,Rutgers,1951,N,N
9,0,0,9,FBS Independents,,San Francisco,1951,N,N
10,8,0,2,FBS Independents,,San Josï¿½ State,1951,N,N
9,5,0,4,FBS Independents,,Santa Clara,1951,N,N
10,6,0,4,Southwest,,SMU,1951,N,N
9,4,0,5,Southern,,South Carolina,1951,N,N
11,2,0,9,Pacific,,Stanford,1951,N,N
9,4,0,5,FBS Independents,,Syracuse,1951,N,N
11,5,0,6,Southwest,,TCU,1951,N,N
10,4,0,6,FBS Independents,,Temple,1951,N,N
11,1,0,10,SEC,,Tennessee,1951,N,N
10,3,0,7,Southwest,,Texas,1951,N,N
10,5,0,5,Southwest,,Texas A&M,1951,N,N
11,4,0,7,Border,,Texas Tech,1951,N,N
10,6,0,4,Southern,,The Citadel,1951,N,N
10,6,0,4,SEC,,Tulane,1951,N,N
11,2,0,9,Missouri Valley,,Tulsa,1951,N,N
9,4,0,5,Pacific,,UCLA,1951,N,N
10,3,0,7,Pacific,,USC,1951,N,N
11,4,0,7,Skyline,,Utah,1951,N,N
9,5,0,4,Skyline,,Utah State,1951,N,N
10,7,0,3,Border,,UTEP,1951,N,N
11,5,0,6,SEC,,Vanderbilt,1951,N,N
8,3,0,5,FBS Independents,,Villanova,1951,N,N
9,1,0,8,FBS Independents,,Virginia,1951,N,N
10,8,0,2,Southern,,Virginia Tech,1951,N,N
10,3,0,7,Southern,,VMI,1951,N,N
10,4,0,6,Southern,,Wake Forest,1951,N,N
10,6,0,4,Pacific,,Washington,1951,N,N
10,4,0,6,Southern,,Washington & Lee,1951,N,N
10,3,0,7,Pacific,,Washington State,1951,N,N
9,7,0,2,Border,,West Texas A&M,1951,N,N
10,5,0,5,Southern,,West Virginia,1951,N,N
9,7,0,2,Missouri Valley,,Wichita State,1951,N,N
10,3,0,7,Southern,,William & Mary,1951,N,N
9,2,0,7,Western,,Wisconsin,1951,N,N
10,3,0,7,Skyline,,Wyoming,1951,N,N
9,7,0,2,FBS Independents,,Yale,1951,N,N
12,2,0,10,SEC,,Alabama,1952,N,N
10,4,0,6,Border,,Arizona,1952,N,N
9,3,0,6,Border,,Arizona State,1952,N,N
10,8,0,2,Southwest,,Arkansas,1952,N,N
9,4,0,5,FBS Independents,,Army,1952,N,N
10,8,0,2,SEC,,Auburn,1952,N,N
10,4,0,6,Southwest,,Baylor,1952,N,N
9,4,0,5,FBS Independents,,Boston College,1952,N,N
10,5,0,5,FBS Independents,,Boston University,1952,N,N
9,7,0,2,FBS Independents,,Brown,1952,N,N
10,6,0,4,Skyline,,BYU,1952,N,N
10,3,0,7,Pacific,,California,1952,N,N
9,6,0,3,FBS Independents,,Clemson,1952,N,N
9,3,0,6,FBS Independents,,Colgate,1952,N,N
10,4,0,6,Big 7,,Colorado,1952,N,N
10,4,0,6,Skyline,,Colorado State,1952,N,N
9,7,0,2,FBS Independents,,Columbia,1952,N,N
9,7,0,2,FBS Independents,,Cornell,1952,N,N
9,7,0,2,FBS Independents,,Dartmouth,1952,N,N
9,7,0,2,Southern,,Davidson,1952,N,N
10,7,0,3,Skyline,,Denver,1952,N,N
9,6,0,3,Missouri Valley,,Detroit Mercy,1952,N,N
9,7,0,2,FBS Independents,,Drake,1952,N,N
10,2,0,8,Southern,,Duke,1952,N,N
11,3,0,8,SEC,,Florida,1952,N,N
8,6,0,2,FBS Independents,,Fordham,1952,N,N
10,3,0,7,Southern,,Furman,1952,N,N
9,3,0,6,Southern,,George Washington,1952,N,N
11,4,0,7,SEC,,Georgia,1952,N,N
12,0,0,12,SEC,,Georgia Tech,1952,N,N
10,4,0,6,Border,,Hardin-Simmons,1952,N,N
9,4,0,5,FBS Independents,,Harvard,1952,N,N
10,2,0,8,FBS Independents,,Holy Cross,1952,N,N
10,2,0,8,Missouri Valley,,Houston,1952,N,N
9,5,0,4,Pacific,,Idaho,1952,N,N
9,5,0,4,Western,,Illinois,1952,N,N
9,7,0,2,Western,,Indiana,1952,N,N
9,7,0,2,Western,,Iowa,1952,N,N
9,6,0,3,Big 7,,Iowa State,1952,N,N
10,3,0,7,Big 7,,Kansas,1952,N,N
10,9,0,1,Big 7,,Kansas State,1952,N,N
11,5,0,6,SEC,,Kentucky,1952,N,N
10,7,0,3,SEC,,LSU,1952,N,N
9,5,0,4,FBS Independents,,Marquette,1952,N,N
9,2,0,7,FBS Independents,,Maryland,1952,N,N
11,7,0,4,FBS Independents,,Miami,1952,N,N
9,4,0,5,Western,,Michigan,1952,N,N
9,0,0,9,FBS Independents,,Michigan State,1952,Y,N
9,4,0,5,Western,,Minnesota,1952,N,N
9,4,0,5,SEC,,Mississippi State,1952,N,N
10,5,0,5,Big 7,,Missouri,1952,N,N
10,7,0,3,Skyline,,Montana,1952,N,N
9,2,0,7,FBS Independents,,Navy,1952,N,N
10,7,0,3,Southern,,NC State,1952,N,N
10,4,0,6,Big 7,,Nebraska,1952,N,N
9,2,0,7,Skyline,,New Mexico,1952,N,N
9,7,0,2,Border,,New Mexico State,1952,N,N
8,5,0,3,FBS Independents,,New York University,1952,N,N
8,6,0,2,Southern,,North Carolina,1952,N,N
7,4,0,3,Border,,Northern Arizona,1952,N,N
9,7,0,2,Western,,Northwestern,1952,N,N
10,2,0,8,FBS Independents,,Notre Dame,1952,N,N
9,3,0,6,Western,,Ohio State,1952,N,N
10,1,0,9,Big 7,,Oklahoma,1952,N,N
10,7,0,3,Missouri Valley,,Oklahoma State,1952,N,N
11,1,0,10,SEC,,Ole Miss,1952,N,N
10,8,0,2,Pacific,,Oregon,1952,N,N
9,7,0,2,Pacific,,Oregon State,1952,N,N
11,4,0,7,FBS Independents,,Pacific,1952,N,N
10,3,0,7,FBS Independents,,Penn State,1952,N,N
9,3,0,6,FBS Independents,,Pittsburgh,1952,N,N
9,1,0,8,FBS Independents,,Princeton,1952,N,N
9,3,0,6,Western,,Purdue,1952,N,N
10,5,0,5,Southwest,,Rice,1952,N,N
10,9,0,1,Southern,,Richmond,1952,N,N
9,5,0,4,FBS Independents,,Rutgers,1952,N,N
9,3,0,6,FBS Independents,,San Josï¿½ State,1952,N,N
9,7,0,2,FBS Independents,,Santa Clara,1952,N,N
10,6,0,4,Southwest,,SMU,1952,N,N
10,5,0,5,Southern,,South Carolina,1952,N,N
10,5,0,5,Pacific,,Stanford,1952,N,N
10,3,0,7,FBS Independents,,Syracuse,1952,N,N
10,5,0,5,Southwest,,TCU,1952,N,N
10,7,0,3,FBS Independents,,Temple,1952,N,N
11,3,0,8,SEC,,Tennessee,1952,N,N
11,2,0,9,Southwest,,Texas,1952,N,N
10,7,0,3,Southwest,,Texas A&M,1952,N,N
11,7,0,4,Border,,Texas Tech,1952,N,N
9,6,0,3,Southern,,The Citadel,1952,N,N
10,5,0,5,SEC,,Tulane,1952,N,N
11,3,0,8,Missouri Valley,,Tulsa,1952,N,N
9,1,0,8,Pacific,,UCLA,1952,N,N
11,1,0,10,Pacific,,USC,1952,N,N
10,3,0,7,Skyline,,Utah,1952,N,N
11,7,0,4,Skyline,,Utah State,1952,N,N
11,5,0,6,Border,,UTEP,1952,N,N
10,6,0,4,SEC,,Vanderbilt,1952,N,N
9,2,0,7,FBS Independents,,Villanova,1952,N,N
10,2,0,8,FBS Independents,,Virginia,1952,N,N
11,6,0,5,Southern,,Virginia Tech,1952,N,N
10,6,0,4,Southern,,VMI,1952,N,N
10,5,0,5,Southern,,Wake Forest,1952,N,N
10,3,0,7,Pacific,,Washington,1952,N,N
10,7,0,3,Southern,,Washington & Lee,1952,N,N
10,6,0,4,Pacific,,Washington State,1952,N,N
9,6,0,3,Border,,West Texas A&M,1952,N,N
9,2,0,7,Southern,,West Virginia,1952,N,N
10,7,0,3,Missouri Valley,,Wichita State,1952,N,N
9,5,0,4,Southern,,William & Mary,1952,N,N
10,4,0,6,Western,,Wisconsin,1952,N,N
9,4,0,5,Skyline,,Wyoming,1952,N,N
9,2,0,7,FBS Independents,,Yale,1952,N,N
12,6,0,6,SEC,,Alabama,1953,N,N
10,6,0,4,Border,,Arizona,1953,N,N
10,6,0,4,Border,,Arizona State,1953,N,N
10,7,0,3,Southwest,,Arkansas,1953,N,N
9,1,0,8,FBS Independents,,Army,1953,N,N
11,3,0,8,SEC,,Auburn,1953,N,N
10,3,0,7,Southwest,,Baylor,1953,N,N
9,4,0,5,FBS Independents,,Boston College,1953,N,N
9,3,0,6,FBS Independents,,Boston University,1953,N,N
9,6,0,3,FBS Independents,,Brown,1953,N,N
10,7,0,3,Skyline,,BYU,1953,N,N
10,5,0,5,Pacific,,California,1953,N,N
9,5,0,4,ACC,,Clemson,1953,N,N
9,4,0,5,FBS Independents,,Colgate,1953,N,N
10,4,0,6,Big 7,,Colorado,1953,N,N
9,5,0,4,Skyline,,Colorado State,1953,N,N
9,5,0,4,FBS Independents,,Columbia,1953,N,N
9,4,0,5,FBS Independents,,Cornell,1953,N,N
9,7,0,2,FBS Independents,,Dartmouth,1953,N,N
9,9,0,0,Southern,,Davidson,1953,N,N
10,6,0,4,Skyline,,Denver,1953,N,N
10,4,0,6,Missouri Valley,,Detroit Mercy,1953,N,N
8,4,0,4,FBS Independents,,Drake,1953,N,N
10,2,0,8,ACC,,Duke,1953,N,N
10,7,0,3,SEC,,Florida,1953,N,N
9,5,0,4,FBS Independents,,Fordham,1953,N,N
9,2,0,7,Southern,,Furman,1953,N,N
9,4,0,5,Southern,,George Washington,1953,N,N
11,8,0,3,SEC,,Georgia,1953,N,N
12,2,0,10,SEC,,Georgia Tech,1953,N,N
11,5,0,6,Border,,Hardin-Simmons,1953,N,N
8,2,0,6,FBS Independents,,Harvard,1953,N,N
10,5,0,5,FBS Independents,,Holy Cross,1953,N,N
9,4,0,5,Missouri Valley,,Houston,1953,N,N
9,8,0,1,Pacific,,Idaho,1953,N,N
9,2,0,7,Big Ten,,Illinois,1953,N,N
9,7,0,2,Big Ten,,Indiana,1953,N,N
9,3,0,6,Big Ten,,Iowa,1953,N,N
9,7,0,2,Big 7,,Iowa State,1953,N,N
10,8,0,2,Big 7,,Kansas,1953,N,N
10,3,0,7,Big 7,,Kansas State,1953,N,N
10,2,0,8,SEC,,Kentucky,1953,N,N
11,4,0,7,SEC,,LSU,1953,N,N
10,4,0,6,FBS Independents,,Marquette,1953,N,N
11,1,0,10,ACC,,Maryland,1953,Y,N
9,5,0,4,FBS Independents,,Miami,1953,N,N
9,3,0,6,Big Ten,,Michigan,1953,N,N
10,1,0,9,Big Ten,,Michigan State,1953,N,N
9,5,0,4,Big Ten,,Minnesota,1953,N,N
10,4,0,6,SEC,,Mississippi State,1953,N,N
10,4,0,6,Big 7,,Missouri,1953,N,N
8,5,0,3,Skyline,,Montana,1953,N,N
9,5,0,4,FBS Independents,,Navy,1953,N,N
10,9,0,1,ACC,,NC State,1953,N,N
10,6,0,4,Big 7,,Nebraska,1953,N,N
9,4,0,5,Skyline,,New Mexico,1953,N,N
9,7,0,2,Border,,New Mexico State,1953,N,N
10,6,0,4,ACC,,North Carolina,1953,N,N
10,6,0,4,FBS Independents,,North Texas,1953,N,N
9,6,0,3,Big Ten,,Northwestern,1953,N,N
10,1,0,9,FBS Independents,,Notre Dame,1953,N,N
9,3,0,6,Big Ten,,Ohio State,1953,N,N
11,1,0,10,Big 7,,Oklahoma,1953,N,N
10,3,0,7,Missouri Valley,,Oklahoma State,1953,N,N
10,2,0,8,SEC,,Ole Miss,1953,N,N
10,5,0,5,Pacific,,Oregon,1953,N,N
9,6,0,3,Pacific,,Oregon State,1953,N,N
10,5,0,5,FBS Independents,,Pacific,1953,N,N
9,3,0,6,FBS Independents,,Penn State,1953,N,N
9,6,0,3,FBS Independents,,Pittsburgh,1953,N,N
9,4,0,5,FBS Independents,,Princeton,1953,N,N
9,7,0,2,Big Ten,,Purdue,1953,N,N
11,2,0,9,Southwest,,Rice,1953,N,N
9,4,0,5,Southern,,Richmond,1953,N,N
8,6,0,2,FBS Independents,,Rutgers,1953,N,N
9,5,0,4,FBS Independents,,San Josï¿½ State,1953,N,N
10,5,0,5,Southwest,,SMU,1953,N,N
10,3,0,7,ACC,,South Carolina,1953,N,N
10,4,0,6,Pacific,,Stanford,1953,N,N
9,4,0,5,FBS Independents,,Syracuse,1953,N,N
10,7,0,3,Southwest,,TCU,1953,N,N
11,4,0,7,SEC,,Tennessee,1953,N,N
10,3,0,7,Southwest,,Texas,1953,N,N
10,6,0,4,Southwest,,Texas A&M,1953,N,N
12,1,0,11,Border,,Texas Tech,1953,N,N
9,7,0,2,Southern,,The Citadel,1953,N,N
10,9,0,1,SEC,,Tulane,1953,N,N
10,7,0,3,Missouri Valley,,Tulsa,1953,N,N
10,2,0,8,Pacific,,UCLA,1953,N,N
10,3,0,7,Pacific,,USC,1953,N,N
10,2,0,8,Skyline,,Utah,1953,N,N
11,3,0,8,Skyline,,Utah State,1953,N,N
10,2,0,8,Border,,UTEP,1953,N,N
10,7,0,3,SEC,,Vanderbilt,1953,N,N
10,6,0,4,FBS Independents,,Villanova,1953,N,N
9,8,0,1,FBS Independents,,Virginia,1953,N,N
10,5,0,5,Southern,,Virginia Tech,1953,N,N
10,5,0,5,Southern,,VMI,1953,N,N
10,6,0,4,ACC,,Wake Forest,1953,N,N
10,7,0,3,Pacific,,Washington,1953,N,N
10,6,0,4,Southern,,Washington & Lee,1953,N,N
10,6,0,4,Pacific,,Washington State,1953,N,N
10,9,0,1,Border,,West Texas A&M,1953,N,N
10,2,0,8,Southern,,West Virginia,1953,N,N
9,5,0,4,Missouri Valley,,Wichita State,1953,N,N
10,4,0,6,Southern,,William & Mary,1953,N,N
9,2,0,7,Big Ten,,Wisconsin,1953,N,N
10,4,0,6,Skyline,,Wyoming,1953,N,N
9,3,0,6,FBS Independents,,Yale,1953,N,N
11,6,0,5,SEC,,Alabama,1954,N,N
10,3,0,7,Border,,Arizona,1954,N,N
10,5,0,5,Border,,Arizona State,1954,N,N
11,3,0,8,Southwest,,Arkansas,1954,N,N
9,2,0,7,FBS Independents,,Army,1954,N,N
11,3,0,8,SEC,,Auburn,1954,N,N
11,4,0,7,Southwest,,Baylor,1954,N,N
9,1,0,8,FBS Independents,,Boston College,1954,N,N
9,2,0,7,FBS Independents,,Boston University,1954,N,N
9,2,0,7,FBS Independents,,Brown,1954,N,N
9,8,0,1,Skyline,,BYU,1954,N,N
10,5,0,5,Pacific,,California,1954,N,N
10,2,0,8,FBS Independents,,Cincinnati,1954,N,N
10,5,0,5,ACC,,Clemson,1954,N,N
9,2,0,7,FBS Independents,,Colgate,1954,N,N
10,2,0,8,Big 7,,Colorado,1954,N,N
10,7,0,3,Skyline,,Colorado State,1954,N,N
9,8,0,1,FBS Independents,,Columbia,1954,N,N
9,4,0,5,FBS Independents,,Cornell,1954,N,N
9,6,0,3,FBS Independents,,Dartmouth,1954,N,N
9,3,0,6,Southern,,Davidson,1954,N,N
10,1,0,9,Skyline,,Denver,1954,N,N
9,7,0,2,Missouri Valley,,Detroit Mercy,1954,N,N
9,7,0,2,FBS Independents,,Drake,1954,N,N
11,2,0,9,ACC,,Duke,1954,N,N
10,5,0,5,SEC,,Florida,1954,N,N
12,4,0,8,FBS Independents,,Florida State,1954,N,N
9,7,0,2,FBS Independents,,Fordham,1954,N,N
10,5,0,5,Southern,,Furman,1954,N,N
9,8,0,1,Southern,,George Washington,1954,N,N
10,3,0,7,SEC,,Georgia,1954,N,N
11,3,0,8,SEC,,Georgia Tech,1954,N,N
10,6,0,4,Border,,Hardin-Simmons,1954,N,N
8,4,0,4,FBS Independents,,Harvard,1954,N,N
10,7,0,3,FBS Independents,,Holy Cross,1954,N,N
10,5,0,5,Missouri Valley,,Houston,1954,N,N
9,5,0,4,Pacific,,Idaho,1954,N,N
9,8,0,1,Big Ten,,Illinois,1954,N,N
9,6,0,3,Big Ten,,Indiana,1954,N,N
9,4,0,5,Big Ten,,Iowa,1954,N,N
9,6,0,3,Big 7,,Iowa State,1954,N,N
10,10,0,0,Big 7,,Kansas,1954,N,N
10,3,0,7,Big 7,,Kansas State,1954,N,N
10,3,0,7,SEC,,Kentucky,1954,N,N
11,6,0,5,SEC,,LSU,1954,N,N
9,6,0,3,FBS Independents,,Marquette,1954,N,N
10,2,0,8,ACC,,Maryland,1954,N,N
9,1,0,8,FBS Independents,,Miami,1954,N,N
9,3,0,6,Big Ten,,Michigan,1954,N,N
9,6,0,3,Big Ten,,Michigan State,1954,N,N
9,2,0,7,Big Ten,,Minnesota,1954,N,N
10,4,0,6,SEC,,Mississippi State,1954,N,N
10,6,0,4,Big 7,,Missouri,1954,N,N
9,6,0,3,Skyline,,Montana,1954,N,N
10,2,0,8,FBS Independents,,Navy,1954,N,N
10,8,0,2,ACC,,NC State,1954,N,N
11,5,0,6,Big 7,,Nebraska,1954,N,N
10,5,0,5,Skyline,,New Mexico,1954,N,N
9,9,0,0,Border,,New Mexico State,1954,N,N
10,5,0,5,ACC,,North Carolina,1954,N,N
10,6,0,4,FBS Independents,,North Texas,1954,N,N
9,7,0,2,Big Ten,,Northwestern,1954,N,N
10,1,0,9,FBS Independents,,Notre Dame,1954,N,N
10,0,0,10,Big Ten,,Ohio State,1954,Y,N
10,0,0,10,Big 7,,Oklahoma,1954,N,N
10,4,0,6,Missouri Valley,,Oklahoma State,1954,N,N
11,2,0,9,SEC,,Ole Miss,1954,N,N
10,4,0,6,Pacific,,Oregon,1954,N,N
9,8,0,1,Pacific,,Oregon State,1954,N,N
9,5,0,4,FBS Independents,,Pacific,1954,N,N
9,2,0,7,FBS Independents,,Penn State,1954,N,N
9,5,0,4,FBS Independents,,Pittsburgh,1954,N,N
9,4,0,5,FBS Independents,,Princeton,1954,N,N
9,4,0,5,Big Ten,,Purdue,1954,N,N
10,3,0,7,Southwest,,Rice,1954,N,N
9,4,0,5,Southern,,Richmond,1954,N,N
9,6,0,3,FBS Independents,,Rutgers,1954,N,N
10,3,0,7,FBS Independents,,San Josï¿½ State,1954,N,N
10,3,0,7,Southwest,,SMU,1954,N,N
10,4,0,6,ACC,,South Carolina,1954,N,N
10,6,0,4,Pacific,,Stanford,1954,N,N
8,4,0,4,FBS Independents,,Syracuse,1954,N,N
10,6,0,4,Southwest,,TCU,1954,N,N
10,6,0,4,SEC,,Tennessee,1954,N,N
10,6,0,4,Southwest,,Texas,1954,N,N
10,9,0,1,Southwest,,Texas A&M,1954,N,N
10,3,0,7,Border,,Texas Tech,1954,N,N
10,8,0,2,Southern,,The Citadel,1954,N,N
10,9,0,1,SEC,,Tulane,1954,N,N
11,11,0,0,Missouri Valley,,Tulsa,1954,N,N
9,0,0,9,Pacific,,UCLA,1954,Y,N
12,4,0,8,Pacific,,USC,1954,N,N
11,7,0,4,Skyline,,Utah,1954,N,N
10,6,0,4,Skyline,,Utah State,1954,N,N
11,3,0,8,Border,,UTEP,1954,N,N
9,7,0,2,SEC,,Vanderbilt,1954,N,N
10,9,0,1,FBS Independents,,Villanova,1954,N,N
9,6,0,3,ACC,,Virginia,1954,N,N
9,1,0,8,Southern,,Virginia Tech,1954,N,N
10,6,0,4,Southern,,VMI,1954,N,N
10,8,0,2,ACC,,Wake Forest,1954,N,N
10,8,0,2,Pacific,,Washington,1954,N,N
10,6,0,4,Pacific,,Washington State,1954,N,N
9,8,0,1,Border,,West Texas A&M,1954,N,N
9,1,0,8,Southern,,West Virginia,1954,N,N
10,1,0,9,Missouri Valley,,Wichita State,1954,N,N
10,4,0,6,Southern,,William & Mary,1954,N,N
9,2,0,7,Big Ten,,Wisconsin,1954,N,N
10,4,0,6,Skyline,,Wyoming,1954,N,N
9,4,0,5,FBS Independents,,Yale,1954,N,N
10,10,0,0,SEC,,Alabama,1955,N,N
10,5,0,5,Border,,Arizona,1955,N,N
11,2,0,9,Border,,Arizona State,1955,N,N
10,5,0,5,Southwest,,Arkansas,1955,N,N
9,3,0,6,FBS Independents,,Army,1955,N,N
11,3,0,8,SEC,,Auburn,1955,N,N
10,5,0,5,Southwest,,Baylor,1955,N,N
8,3,0,5,FBS Independents,,Boston College,1955,N,N
8,6,0,2,FBS Independents,,Boston University,1955,N,N
9,7,0,2,FBS Independents,,Brown,1955,N,N
10,9,0,1,Skyline,,BYU,1955,N,N
10,8,0,2,Pacific,,California,1955,N,N
9,7,0,2,FBS Independents,,Cincinnati,1955,N,N
10,3,0,7,ACC,,Clemson,1955,N,N
9,3,0,6,FBS Independents,,Colgate,1955,N,N
10,4,0,6,Big 7,,Colorado,1955,N,N
10,2,0,8,Skyline,,Colorado State,1955,N,N
9,8,0,1,FBS Independents,,Columbia,1955,N,N
9,4,0,5,FBS Independents,,Cornell,1955,N,N
9,6,0,3,FBS Independents,,Dartmouth,1955,N,N
9,4,0,5,Southern,,Davidson,1955,N,N
10,2,0,8,Skyline,,Denver,1955,N,N
9,3,0,6,Missouri Valley,,Detroit Mercy,1955,N,N
8,4,0,4,FBS Independents,,Drake,1955,N,N
10,2,0,8,ACC,,Duke,1955,N,N
10,6,0,4,SEC,,Florida,1955,N,N
10,5,0,5,FBS Independents,,Florida State,1955,N,N
10,9,0,1,Southern,,Furman,1955,N,N
9,4,0,5,Southern,,George Washington,1955,N,N
10,6,0,4,SEC,,Georgia,1955,N,N
11,1,0,10,SEC,,Georgia Tech,1955,N,N
10,5,0,5,Border,,Hardin-Simmons,1955,N,N
8,5,0,3,FBS Independents,,Harvard,1955,N,N
10,4,0,6,FBS Independents,,Holy Cross,1955,N,N
10,4,0,6,Missouri Valley,,Houston,1955,N,N
9,7,0,2,Pacific,,Idaho,1955,N,N
9,3,0,6,Big Ten,,Illinois,1955,N,N
9,6,0,3,Big Ten,,Indiana,1955,N,N
9,6,0,3,Big Ten,,Iowa,1955,N,N
9,7,0,2,Big 7,,Iowa State,1955,N,N
10,7,0,3,Big 7,,Kansas,1955,N,N
10,6,0,4,Big 7,,Kansas State,1955,N,N
10,3,0,7,SEC,,Kentucky,1955,N,N
10,6,0,4,SEC,,LSU,1955,N,N
9,6,0,3,FBS Independents,,Marquette,1955,N,N
11,1,0,10,ACC,,Maryland,1955,N,N
9,3,0,6,FBS Independents,,Miami,1955,N,N
9,2,0,7,Big Ten,,Michigan,1955,N,N
10,1,0,9,Big Ten,,Michigan State,1955,N,N
9,6,0,3,Big Ten,,Minnesota,1955,N,N
10,4,0,6,SEC,,Mississippi State,1955,N,N
10,9,0,1,Big 7,,Missouri,1955,N,N
10,7,0,3,Skyline,,Montana,1955,N,N
9,3,0,6,FBS Independents,,Navy,1955,N,N
10,6,0,4,ACC,,NC State,1955,N,N
10,5,0,5,Big 7,,Nebraska,1955,N,N
10,8,0,2,Skyline,,New Mexico,1955,N,N
10,7,0,3,Border,,New Mexico State,1955,N,N
10,7,0,3,ACC,,North Carolina,1955,N,N
10,4,0,6,FBS Independents,,North Texas,1955,N,N
9,9,0,0,Big Ten,,Northwestern,1955,N,N
10,2,0,8,FBS Independents,,Notre Dame,1955,N,N
9,2,0,7,Big Ten,,Ohio State,1955,N,N
11,0,0,11,Big 7,,Oklahoma,1955,Y,N
10,8,0,2,Missouri Valley,,Oklahoma State,1955,N,N
11,1,0,10,SEC,,Ole Miss,1955,N,N
10,4,0,6,Pacific,,Oregon,1955,N,N
9,3,0,6,Pacific,,Oregon State,1955,N,N
9,4,0,5,FBS Independents,,Pacific,1955,N,N
9,4,0,5,FBS Independents,,Penn State,1955,N,N
11,4,0,7,FBS Independents,,Pittsburgh,1955,N,N
9,2,0,7,FBS Independents,,Princeton,1955,N,N
9,3,0,6,Big Ten,,Purdue,1955,N,N
10,8,0,2,Southwest,,Rice,1955,N,N
9,4,0,5,Southern,,Richmond,1955,N,N
8,5,0,3,FBS Independents,,Rutgers,1955,N,N
9,3,0,6,FBS Independents,,San Josï¿½ State,1955,N,N
10,6,0,4,Southwest,,SMU,1955,N,N
9,6,0,3,ACC,,South Carolina,1955,N,N
10,3,0,7,Pacific,,Stanford,1955,N,N
8,3,0,5,FBS Independents,,Syracuse,1955,N,N
11,2,0,9,Southwest,,TCU,1955,N,N
10,4,0,6,SEC,,Tennessee,1955,N,N
10,5,0,5,Southwest,,Texas,1955,N,N
10,2,0,8,Southwest,,Texas A&M,1955,N,N
11,3,0,8,Border,,Texas Tech,1955,N,N
9,4,0,5,Southern,,The Citadel,1955,N,N
10,4,0,6,SEC,,Tulane,1955,N,N
10,8,0,2,Missouri Valley,,Tulsa,1955,N,N
11,2,0,9,Pacific,,UCLA,1955,N,N
10,4,0,6,Pacific,,USC,1955,N,N
9,3,0,6,Skyline,,Utah,1955,N,N
10,6,0,4,Skyline,,Utah State,1955,N,N
10,4,0,6,Border,,UTEP,1955,N,N
11,3,0,8,SEC,,Vanderbilt,1955,N,N
10,9,0,1,FBS Independents,,Villanova,1955,N,N
10,9,0,1,ACC,,Virginia,1955,N,N
10,4,0,6,Southern,,Virginia Tech,1955,N,N
10,9,0,1,Southern,,VMI,1955,N,N
10,4,0,6,ACC,,Wake Forest,1955,N,N
10,5,0,5,Pacific,,Washington,1955,N,N
10,8,0,2,Pacific,,Washington State,1955,N,N
9,4,0,5,Border,,West Texas A&M,1955,N,N
10,2,0,8,Southern,,West Virginia,1955,N,N
10,3,0,7,Missouri Valley,,Wichita State,1955,N,N
9,7,0,2,Southern,,William & Mary,1955,N,N
9,5,0,4,Big Ten,,Wisconsin,1955,N,N
11,3,0,8,Skyline,,Wyoming,1955,N,N
9,2,0,7,FBS Independents,,Yale,1955,N,N
10,8,0,2,SEC,,Alabama,1956,N,N
10,6,0,4,Border,,Arizona,1956,N,N
10,1,0,9,Border,,Arizona State,1956,N,N
10,4,0,6,Southwest,,Arkansas,1956,N,N
9,4,0,5,FBS Independents,,Army,1956,N,N
10,3,0,7,SEC,,Auburn,1956,N,N
11,2,0,9,Southwest,,Baylor,1956,N,N
9,4,0,5,FBS Independents,,Boston College,1956,N,N
8,6,0,2,FBS Independents,,Boston University,1956,N,N
9,4,0,5,Ivy,,Brown,1956,N,N
10,7,0,3,Skyline,,BYU,1956,N,N
10,7,0,3,Pacific,,California,1956,N,N
9,5,0,4,FBS Independents,,Cincinnati,1956,N,N
11,2,0,9,ACC,,Clemson,1956,N,N
9,5,0,4,FBS Independents,,Colgate,1956,N,N
11,2,0,9,Big 7,,Colorado,1956,N,N
10,8,0,2,Skyline,,Colorado State,1956,N,N
9,6,0,3,Ivy,,Columbia,1956,N,N
9,8,0,1,Ivy,,Cornell,1956,N,N
9,4,0,5,Ivy,,Dartmouth,1956,N,N
9,4,0,5,Southern,,Davidson,1956,N,N
10,6,0,4,FBS Independents,,Dayton,1956,N,N
10,4,0,6,Skyline,,Denver,1956,N,N
10,8,0,2,Missouri Valley,,Detroit Mercy,1956,N,N
9,6,0,3,FBS Independents,,Drake,1956,N,N
10,5,0,5,ACC,,Duke,1956,N,N
10,4,0,6,SEC,,Florida,1956,N,N
10,5,0,5,FBS Independents,,Florida State,1956,N,N
10,8,0,2,Southern,,Furman,1956,N,N
10,1,0,9,Southern,,George Washington,1956,N,N
10,6,0,4,SEC,,Georgia,1956,N,N
11,1,0,10,SEC,,Georgia Tech,1956,N,N
10,6,0,4,Border,,Hardin-Simmons,1956,N,N
8,6,0,2,Ivy,,Harvard,1956,N,N
9,3,0,6,FBS Independents,,Holy Cross,1956,N,N
10,3,0,7,Missouri Valley,,Houston,1956,N,N
9,5,0,4,Pacific,,Idaho,1956,N,N
9,6,0,3,Big Ten,,Illinois,1956,N,N
9,6,0,3,Big Ten,,Indiana,1956,N,N
10,1,0,9,Big Ten,,Iowa,1956,N,N
10,8,0,2,Big 7,,Iowa State,1956,N,N
10,7,0,3,Big 7,,Kansas,1956,N,N
10,7,0,3,Big 7,,Kansas State,1956,N,N
10,4,0,6,SEC,,Kentucky,1956,N,N
10,7,0,3,SEC,,LSU,1956,N,N
9,9,0,0,FBS Independents,,Marquette,1956,N,N
10,8,0,2,ACC,,Maryland,1956,N,N
10,2,0,8,FBS Independents,,Miami,1956,N,N
9,2,0,7,Big Ten,,Michigan,1956,N,N
9,2,0,7,Big Ten,,Michigan State,1956,N,N
9,2,0,7,Big Ten,,Minnesota,1956,N,N
10,6,0,4,SEC,,Mississippi State,1956,N,N
10,6,0,4,Big 7,,Missouri,1956,N,N
10,9,0,1,Skyline,,Montana,1956,N,N
9,1,0,8,FBS Independents,,Navy,1956,N,N
10,7,0,3,ACC,,NC State,1956,N,N
10,6,0,4,Big 7,,Nebraska,1956,N,N
10,6,0,4,Skyline,,New Mexico,1956,N,N
10,9,0,1,Border,,New Mexico State,1956,N,N
10,8,0,2,ACC,,North Carolina,1956,N,N
10,3,0,7,FBS Independents,,North Texas,1956,N,N
9,4,0,5,Big Ten,,Northwestern,1956,N,N
10,8,0,2,FBS Independents,,Notre Dame,1956,N,N
9,3,0,6,Big Ten,,Ohio State,1956,N,N
10,0,0,10,Big 7,,Oklahoma,1956,Y,N
10,5,0,5,Missouri Valley,,Oklahoma State,1956,N,N
10,3,0,7,SEC,,Ole Miss,1956,N,N
10,5,0,5,Pacific,,Oregon,1956,N,N
11,4,0,7,Pacific,,Oregon State,1956,N,N
10,3,0,7,FBS Independents,,Pacific,1956,N,N
9,2,0,7,FBS Independents,,Penn State,1956,N,N
9,5,0,4,Ivy,,Pennsylvania,1956,N,N
11,4,0,7,FBS Independents,,Pittsburgh,1956,N,N
9,2,0,7,Ivy,,Princeton,1956,N,N
9,5,0,4,Big Ten,,Purdue,1956,N,N
10,6,0,4,Southwest,,Rice,1956,N,N
9,5,0,4,Southern,,Richmond,1956,N,N
10,7,0,3,FBS Independents,,Rutgers,1956,N,N
10,7,0,3,FBS Independents,,San Josï¿½ State,1956,N,N
10,6,0,4,Southwest,,SMU,1956,N,N
10,3,0,7,ACC,,South Carolina,1956,N,N
10,6,0,4,Pacific,,Stanford,1956,N,N
9,2,0,7,FBS Independents,,Syracuse,1956,N,N
11,3,0,8,Southwest,,TCU,1956,N,N
11,1,0,10,SEC,,Tennessee,1956,N,N
10,9,0,1,Southwest,,Texas,1956,N,N
10,0,0,10,Southwest,,Texas A&M,1956,N,N
10,8,0,2,FBS Independents,,Texas Tech,1956,N,N
9,6,0,3,Southern,,The Citadel,1956,N,N
10,4,0,6,SEC,,Tulane,1956,N,N
10,3,0,7,Missouri Valley,,Tulsa,1956,N,N
10,3,0,7,Pacific,,UCLA,1956,N,N
10,2,0,8,Pacific,,USC,1956,N,N
10,5,0,5,Skyline,,Utah,1956,N,N
10,4,0,6,Skyline,,Utah State,1956,N,N
11,2,0,9,Border,,UTEP,1956,N,N
10,5,0,5,SEC,,Vanderbilt,1956,N,N
9,4,0,5,FBS Independents,,Villanova,1956,N,N
10,7,0,3,ACC,,Virginia,1956,N,N
10,3,0,7,Southern,,Virginia Tech,1956,N,N
10,6,0,4,Southern,,VMI,1956,N,N
10,5,0,5,ACC,,Wake Forest,1956,N,N
10,5,0,5,Pacific,,Washington,1956,N,N
10,6,0,4,Pacific,,Washington State,1956,N,N
10,2,0,8,Border,,West Texas A&M,1956,N,N
10,4,0,6,Southern,,West Virginia,1956,N,N
10,6,0,4,Missouri Valley,,Wichita State,1956,N,N
10,10,0,0,Southern,,William & Mary,1956,N,N
9,7,0,2,Big Ten,,Wisconsin,1956,N,N
10,0,0,10,Skyline,,Wyoming,1956,N,N
9,1,0,8,Ivy,,Yale,1956,N,N
10,6,0,4,FBS Independents,,Air Force,1957,N,N
10,7,0,3,SEC,,Alabama,1957,N,N
10,9,0,1,Border,,Arizona,1957,N,N
10,0,0,10,Border,,Arizona State,1957,N,N
10,4,0,6,Southwest,,Arkansas,1957,N,N
9,2,0,7,FBS Independents,,Army,1957,N,N
10,0,0,10,SEC,,Auburn,1957,Y,N
10,6,0,4,Southwest,,Baylor,1957,N,N
9,2,0,7,FBS Independents,,Boston College,1957,N,N
8,3,0,5,FBS Independents,,Boston University,1957,N,N
9,4,0,5,Ivy,,Brown,1957,N,N
10,3,0,7,Skyline,,BYU,1957,N,N
10,9,0,1,Pacific,,California,1957,N,N
10,5,0,5,Missouri Valley,,Cincinnati,1957,N,N
10,3,0,7,ACC,,Clemson,1957,N,N
9,6,0,3,FBS Independents,,Colgate,1957,N,N
10,3,0,7,Big 7,,Colorado,1957,N,N
10,7,0,3,Skyline,,Colorado State,1957,N,N
9,8,0,1,Ivy,,Columbia,1957,N,N
9,6,0,3,Ivy,,Cornell,1957,N,N
9,1,0,8,Ivy,,Dartmouth,1957,N,N
8,3,0,5,Southern,,Davidson,1957,N,N
10,3,0,7,FBS Independents,,Dayton,1957,N,N
10,4,0,6,Skyline,,Denver,1957,N,N
9,3,0,6,FBS Independents,,Detroit Mercy,1957,N,N
9,2,0,7,FBS Independents,,Drake,1957,N,N
11,3,0,8,ACC,,Duke,1957,N,N
9,2,0,7,SEC,,Florida,1957,N,N
10,6,0,4,FBS Independents,,Florida State,1957,N,N
10,7,0,3,Southern,,Furman,1957,N,N
9,7,0,2,Southern,,George Washington,1957,N,N
10,7,0,3,SEC,,Georgia,1957,N,N
10,6,0,4,SEC,,Georgia Tech,1957,N,N
10,5,0,5,Border,,Hardin-Simmons,1957,N,N
8,5,0,3,Ivy,,Harvard,1957,N,N
9,4,0,5,FBS Independents,,Holy Cross,1957,N,N
10,5,0,5,Missouri Valley,,Houston,1957,N,N
9,4,0,5,Pacific,,Idaho,1957,N,N
9,5,0,4,Big Ten,,Illinois,1957,N,N
9,8,0,1,Big Ten,,Indiana,1957,N,N
9,1,0,8,Big Ten,,Iowa,1957,N,N
10,5,0,5,Big 7,,Iowa State,1957,N,N
10,4,0,6,Big 7,,Kansas,1957,N,N
10,6,0,4,Big 7,,Kansas State,1957,N,N
10,7,0,3,SEC,,Kentucky,1957,N,N
10,5,0,5,SEC,,LSU,1957,N,N
10,10,0,0,FBS Independents,,Marquette,1957,N,N
10,5,0,5,ACC,,Maryland,1957,N,N
10,5,0,5,FBS Independents,,Miami,1957,N,N
9,4,0,5,Big Ten,,Michigan,1957,N,N
9,1,0,8,Big Ten,,Michigan State,1957,N,N
9,5,0,4,Big Ten,,Minnesota,1957,N,N
9,3,0,6,SEC,,Mississippi State,1957,N,N
10,4,0,6,Big 7,,Missouri,1957,N,N
9,7,0,2,Skyline,,Montana,1957,N,N
11,2,0,9,FBS Independents,,Navy,1957,N,N
10,2,0,8,ACC,,NC State,1957,N,N
10,9,0,1,Big 7,,Nebraska,1957,N,N
10,6,0,4,Skyline,,New Mexico,1957,N,N
10,7,0,3,Border,,New Mexico State,1957,N,N
10,4,0,6,ACC,,North Carolina,1957,N,N
10,5,0,5,Missouri Valley,,North Texas,1957,N,N
9,9,0,0,Big Ten,,Northwestern,1957,N,N
10,3,0,7,FBS Independents,,Notre Dame,1957,N,N
10,1,0,9,Big Ten,,Ohio State,1957,Y,N
11,1,0,10,Big 7,,Oklahoma,1957,N,N
10,3,0,7,FBS Independents,,Oklahoma State,1957,N,N
11,1,0,10,SEC,,Ole Miss,1957,N,N
11,4,0,7,Pacific,,Oregon,1957,N,N
10,2,0,8,Pacific,,Oregon State,1957,N,N
10,5,0,5,FBS Independents,,Pacific,1957,N,N
9,3,0,6,FBS Independents,,Penn State,1957,N,N
9,6,0,3,Ivy,,Pennsylvania,1957,N,N
10,6,0,4,FBS Independents,,Pittsburgh,1957,N,N
9,2,0,7,Ivy,,Princeton,1957,N,N
9,4,0,5,Big Ten,,Purdue,1957,N,N
11,4,0,7,Southwest,,Rice,1957,N,N
10,6,0,4,Southern,,Richmond,1957,N,N
9,4,0,5,FBS Independents,,Rutgers,1957,N,N
10,7,0,3,FBS Independents,,San Josï¿½ State,1957,N,N
10,5,0,5,Southwest,,SMU,1957,N,N
10,5,0,5,ACC,,South Carolina,1957,N,N
10,4,0,6,Pacific,,Stanford,1957,N,N
9,4,0,5,FBS Independents,,Syracuse,1957,N,N
10,5,0,5,Southwest,,TCU,1957,N,N
11,3,0,8,SEC,,Tennessee,1957,N,N
11,5,0,6,Southwest,,Texas,1957,N,N
11,3,0,8,Southwest,,Texas A&M,1957,N,N
10,8,0,2,FBS Independents,,Texas Tech,1957,N,N
10,5,0,5,Southern,,The Citadel,1957,N,N
10,8,0,2,SEC,,Tulane,1957,N,N
10,6,0,4,Missouri Valley,,Tulsa,1957,N,N
10,2,0,8,Pacific,,UCLA,1957,N,N
10,9,0,1,Pacific,,USC,1957,N,N
10,4,0,6,Skyline,,Utah,1957,N,N
10,7,0,3,Skyline,,Utah State,1957,N,N
9,3,0,6,Border,,UTEP,1957,N,N
10,5,0,5,SEC,,Vanderbilt,1957,N,N
9,6,0,3,FBS Independents,,Villanova,1957,N,N
10,6,0,4,ACC,,Virginia,1957,N,N
10,6,0,4,Southern,,Virginia Tech,1957,N,N
10,0,0,10,Southern,,VMI,1957,N,N
10,10,0,0,ACC,,Wake Forest,1957,N,N
10,7,0,3,Pacific,,Washington,1957,N,N
10,4,0,6,Pacific,,Washington State,1957,N,N
10,3,0,7,Border,,West Texas A&M,1957,N,N
10,3,0,7,Southern,,West Virginia,1957,N,N
10,9,0,1,Missouri Valley,,Wichita State,1957,N,N
10,6,0,4,Southern,,William & Mary,1957,N,N
9,3,0,6,Big Ten,,Wisconsin,1957,N,N
10,6,0,4,Skyline,,Wyoming,1957,N,N
9,3,0,6,Ivy,,Yale,1957,N,N
11,0,0,11,FBS Independents,,Air Force,1958,N,N
10,5,0,5,SEC,,Alabama,1958,N,N
10,7,0,3,Border,,Arizona,1958,N,N
10,3,0,7,Border,,Arizona State,1958,N,N
10,6,0,4,Southwest,,Arkansas,1958,N,N
9,0,0,9,FBS Independents,,Army,1958,N,N
10,0,0,10,SEC,,Auburn,1958,N,N
10,7,0,3,Southwest,,Baylor,1958,N,N
10,3,0,7,FBS Independents,,Boston College,1958,N,N
9,5,0,4,FBS Independents,,Boston University,1958,N,N
9,3,0,6,Ivy,,Brown,1958,N,N
10,4,0,6,Skyline,,BYU,1958,N,N
11,4,0,7,Pacific,,California,1958,N,N
10,3,0,7,Missouri Valley,,Cincinnati,1958,N,N
11,3,0,8,ACC,,Clemson,1958,N,N
9,8,0,1,FBS Independents,,Colgate,1958,N,N
10,4,0,6,Big 7,,Colorado,1958,N,N
10,4,0,6,Skyline,,Colorado State,1958,N,N
9,8,0,1,Ivy,,Columbia,1958,N,N
9,3,0,6,Ivy,,Cornell,1958,N,N
9,2,0,7,Ivy,,Dartmouth,1958,N,N
9,4,0,5,Southern,,Davidson,1958,N,N
10,8,0,2,FBS Independents,,Dayton,1958,N,N
10,8,0,2,Skyline,,Denver,1958,N,N
9,5,0,4,FBS Independents,,Detroit Mercy,1958,N,N
9,7,0,2,FBS Independents,,Drake,1958,N,N
10,5,0,5,ACC,,Duke,1958,N,N
11,5,0,6,SEC,,Florida,1958,N,N
11,4,0,7,FBS Independents,,Florida State,1958,N,N
9,7,0,2,Southern,,Furman,1958,N,N
8,5,0,3,Southern,,George Washington,1958,N,N
10,6,0,4,SEC,,Georgia,1958,N,N
10,5,0,5,SEC,,Georgia Tech,1958,N,N
11,5,0,6,Border,,Hardin-Simmons,1958,N,N
9,5,0,4,Ivy,,Harvard,1958,N,N
9,3,0,6,FBS Independents,,Holy Cross,1958,N,N
9,4,0,5,Missouri Valley,,Houston,1958,N,N
9,5,0,4,Pacific,,Idaho,1958,N,N
9,5,0,4,Big Ten,,Illinois,1958,N,N
9,3,0,6,Big Ten,,Indiana,1958,N,N
10,2,0,8,Big Ten,,Iowa,1958,Y,N
10,6,0,4,Big 7,,Iowa State,1958,N,N
10,5,0,5,Big 7,,Kansas,1958,N,N
10,7,0,3,Big 7,,Kansas State,1958,N,N
10,5,0,5,SEC,,Kentucky,1958,N,N
11,0,0,11,SEC,,LSU,1958,Y,N
10,7,0,3,FBS Independents,,Marquette,1958,N,N
10,6,0,4,ACC,,Maryland,1958,N,N
10,8,0,2,FBS Independents,,Miami,1958,N,N
9,6,0,3,Big Ten,,Michigan,1958,N,N
9,6,0,3,Big Ten,,Michigan State,1958,N,N
9,8,0,1,Big Ten,,Minnesota,1958,N,N
9,6,0,3,SEC,,Mississippi State,1958,N,N
10,5,0,5,Big 7,,Missouri,1958,N,N
10,10,0,0,Skyline,,Montana,1958,N,N
9,3,0,6,FBS Independents,,Navy,1958,N,N
10,8,0,2,ACC,,NC State,1958,N,N
10,7,0,3,Big 7,,Nebraska,1958,N,N
10,3,0,7,Skyline,,New Mexico,1958,N,N
10,6,0,4,Border,,New Mexico State,1958,N,N
10,4,0,6,ACC,,North Carolina,1958,N,N
10,3,0,7,Missouri Valley,,North Texas,1958,N,N
9,4,0,5,Big Ten,,Northwestern,1958,N,N
10,4,0,6,FBS Independents,,Notre Dame,1958,N,N
9,3,0,6,Big Ten,,Ohio State,1958,N,N
11,1,0,10,Big 7,,Oklahoma,1958,N,N
11,3,0,8,FBS Independents,,Oklahoma State,1958,N,N
11,2,0,9,SEC,,Ole Miss,1958,N,N
10,6,0,4,Pacific,,Oregon,1958,N,N
10,4,0,6,Pacific,,Oregon State,1958,N,N
10,4,0,6,FBS Independents,,Pacific,1958,N,N
10,3,0,7,FBS Independents,,Penn State,1958,N,N
9,5,0,4,Ivy,,Pennsylvania,1958,N,N
10,5,0,5,FBS Independents,,Pittsburgh,1958,N,N
9,3,0,6,Ivy,,Princeton,1958,N,N
9,2,0,7,Big Ten,,Purdue,1958,N,N
10,5,0,5,Southwest,,Rice,1958,N,N
10,7,0,3,Southern,,Richmond,1958,N,N
9,1,0,8,FBS Independents,,Rutgers,1958,N,N
9,5,0,4,FBS Independents,,San Josï¿½ State,1958,N,N
10,4,0,6,Southwest,,SMU,1958,N,N
10,3,0,7,ACC,,South Carolina,1958,N,N
10,8,0,2,Pacific,,Stanford,1958,N,N
10,2,0,8,FBS Independents,,Syracuse,1958,N,N
11,3,0,8,Southwest,,TCU,1958,N,N
10,6,0,4,SEC,,Tennessee,1958,N,N
10,3,0,7,Southwest,,Texas,1958,N,N
10,6,0,4,Southwest,,Texas A&M,1958,N,N
10,7,0,3,FBS Independents,,Texas Tech,1958,N,N
10,6,0,4,Southern,,The Citadel,1958,N,N
10,7,0,3,SEC,,Tulane,1958,N,N
10,3,0,7,Missouri Valley,,Tulsa,1958,N,N
10,7,0,3,Pacific,,UCLA,1958,N,N
10,5,0,5,Pacific,,USC,1958,N,N
11,7,0,4,Skyline,,Utah,1958,N,N
10,7,0,3,Skyline,,Utah State,1958,N,N
9,7,0,2,Border,,UTEP,1958,N,N
10,2,0,8,SEC,,Vanderbilt,1958,N,N
10,4,0,6,FBS Independents,,Villanova,1958,N,N
10,9,0,1,ACC,,Virginia,1958,N,N
10,4,0,6,Southern,,Virginia Tech,1958,N,N
10,4,0,6,Southern,,VMI,1958,N,N
10,7,0,3,ACC,,Wake Forest,1958,N,N
10,7,0,3,Pacific,,Washington,1958,N,N
10,3,0,7,Pacific,,Washington State,1958,N,N
10,9,0,1,Border,,West Texas A&M,1958,N,N
10,6,0,4,Southern,,West Virginia,1958,N,N
10,5,0,5,Missouri Valley,,Wichita State,1958,N,N
9,6,0,3,Southern,,William & Mary,1958,N,N
9,1,0,8,Big Ten,,Wisconsin,1958,N,N
11,3,0,8,Skyline,,Wyoming,1958,N,N
9,7,0,2,Ivy,,Yale,1958,N,N
10,4,0,6,FBS Independents,,Air Force,1959,N,N
11,3,0,8,SEC,,Alabama,1959,N,N
10,6,0,4,Border,,Arizona,1959,N,N
11,1,0,10,Border,,Arizona State,1959,N,N
11,2,0,9,Southwest,,Arkansas,1959,N,N
9,5,0,4,FBS Independents,,Army,1959,N,N
10,3,0,7,SEC,,Auburn,1959,N,N
10,6,0,4,Southwest,,Baylor,1959,N,N
9,4,0,5,FBS Independents,,Boston College,1959,N,N
9,5,0,4,FBS Independents,,Boston University,1959,N,N
9,6,0,3,Ivy,,Brown,1959,N,N
10,7,0,3,Skyline,,BYU,1959,N,N
10,8,0,2,AAWU,,California,1959,N,N
10,4,0,6,Missouri Valley,,Cincinnati,1959,N,N
11,2,0,9,ACC,,Clemson,1959,N,N
9,7,0,2,FBS Independents,,Colgate,1959,N,N
10,5,0,5,Big 7,,Colorado,1959,N,N
10,4,0,6,Skyline,,Colorado State,1959,N,N
9,7,0,2,Ivy,,Columbia,1959,N,N
9,4,0,5,Ivy,,Cornell,1959,N,N
9,4,0,5,Ivy,,Dartmouth,1959,N,N
9,8,0,1,Southern,,Davidson,1959,N,N
10,7,0,3,FBS Independents,,Dayton,1959,N,N
10,8,0,2,Skyline,,Denver,1959,N,N
10,4,0,6,FBS Independents,,Detroit Mercy,1959,N,N
10,6,0,4,ACC,,Duke,1959,N,N
10,4,0,6,SEC,,Florida,1959,N,N
10,6,0,4,FBS Independents,,Florida State,1959,N,N
10,7,0,3,Southern,,Furman,1959,N,N
9,8,0,1,Southern,,George Washington,1959,N,N
11,1,0,10,SEC,,Georgia,1959,N,N
11,5,0,6,SEC,,Georgia Tech,1959,N,N
10,7,0,3,Border,,Hardin-Simmons,1959,N,N
9,3,0,6,Ivy,,Harvard,1959,N,N
10,4,0,6,FBS Independents,,Holy Cross,1959,N,N
10,7,0,3,Missouri Valley,,Houston,1959,N,N
10,9,0,1,FBS Independents,,Idaho,1959,N,N
9,4,0,5,Big Ten,,Illinois,1959,N,N
9,4,0,5,Big Ten,,Indiana,1959,N,N
9,4,0,5,Big Ten,,Iowa,1959,N,N
10,3,0,7,Big 7,,Iowa State,1959,N,N
10,5,0,5,Big 7,,Kansas,1959,N,N
10,8,0,2,Big 7,,Kansas State,1959,N,N
10,6,0,4,SEC,,Kentucky,1959,N,N
11,2,0,9,SEC,,LSU,1959,N,N
10,7,0,3,FBS Independents,,Marquette,1959,N,N
10,5,0,5,ACC,,Maryland,1959,N,N
10,4,0,6,FBS Independents,,Miami,1959,N,N
9,5,0,4,Big Ten,,Michigan,1959,N,N
9,4,0,5,Big Ten,,Michigan State,1959,N,N
9,7,0,2,Big Ten,,Minnesota,1959,N,N
9,7,0,2,SEC,,Mississippi State,1959,N,N
11,5,0,6,Big 7,,Missouri,1959,N,N
9,8,0,1,Skyline,,Montana,1959,N,N
10,4,0,6,FBS Independents,,Navy,1959,N,N
10,9,0,1,ACC,,NC State,1959,N,N
10,6,0,4,Big 7,,Nebraska,1959,N,N
10,3,0,7,Skyline,,New Mexico,1959,N,N
11,3,0,8,Border,,New Mexico State,1959,N,N
10,5,0,5,ACC,,North Carolina,1959,N,N
11,2,0,9,Missouri Valley,,North Texas,1959,N,N
9,3,0,6,Big Ten,,Northwestern,1959,N,N
10,5,0,5,FBS Independents,,Notre Dame,1959,N,N
9,6,0,3,Big Ten,,Ohio State,1959,N,N
10,3,0,7,Big 7,,Oklahoma,1959,N,N
10,4,0,6,FBS Independents,,Oklahoma State,1959,N,N
11,1,0,10,SEC,,Ole Miss,1959,N,N
10,2,0,8,FBS Independents,,Oregon,1959,N,N
10,7,0,3,FBS Independents,,Oregon State,1959,N,N
9,4,0,5,FBS Independents,,Pacific,1959,N,N
11,2,0,9,FBS Independents,,Penn State,1959,N,N
9,2,0,7,Ivy,,Pennsylvania,1959,N,N
10,4,0,6,FBS Independents,,Pittsburgh,1959,N,N
9,5,0,4,Ivy,,Princeton,1959,N,N
9,2,0,7,Big Ten,,Purdue,1959,N,N
10,9,0,1,Southwest,,Rice,1959,N,N
10,6,0,4,Southern,,Richmond,1959,N,N
9,3,0,6,FBS Independents,,Rutgers,1959,N,N
10,6,0,4,FBS Independents,,San Josï¿½ State,1959,N,N
10,4,0,6,Southwest,,SMU,1959,N,N
10,4,0,6,ACC,,South Carolina,1959,N,N
10,7,0,3,AAWU,,Stanford,1959,N,N
11,0,0,11,FBS Independents,,Syracuse,1959,Y,N
11,3,0,8,Southwest,,TCU,1959,N,N
10,4,0,6,SEC,,Tennessee,1959,N,N
11,2,0,9,Southwest,,Texas,1959,N,N
10,7,0,3,Southwest,,Texas A&M,1959,N,N
10,6,0,4,FBS Independents,,Texas Tech,1959,N,N
10,2,0,8,Southern,,The Citadel,1959,N,N
10,7,0,3,SEC,,Tulane,1959,N,N
10,5,0,5,Missouri Valley,,Tulsa,1959,N,N
10,5,0,5,AAWU,,UCLA,1959,N,N
10,2,0,8,AAWU,,USC,1959,N,N
10,5,0,5,Skyline,,Utah,1959,N,N
11,6,0,5,Skyline,,Utah State,1959,N,N
10,7,0,3,Border,,UTEP,1959,N,N
10,4,0,6,SEC,,Vanderbilt,1959,N,N
10,9,0,1,FBS Independents,,Villanova,1959,N,N
10,10,0,0,ACC,,Virginia,1959,N,N
10,4,0,6,Southern,,Virginia Tech,1959,N,N
10,1,0,9,Southern,,VMI,1959,N,N
10,4,0,6,ACC,,Wake Forest,1959,N,N
11,1,0,10,AAWU,,Washington,1959,N,N
10,4,0,6,FBS Independents,,Washington State,1959,N,N
10,9,0,1,Border,,West Texas A&M,1959,N,N
10,7,0,3,Southern,,West Virginia,1959,N,N
10,5,0,5,Missouri Valley,,Wichita State,1959,N,N
10,6,0,4,Southern,,William & Mary,1959,N,N
10,3,0,7,Big Ten,,Wisconsin,1959,N,N
10,1,0,9,Skyline,,Wyoming,1959,N,N
10,6,0,4,FBS Independents,,Xavier,1959,N,N
9,3,0,6,Ivy,,Yale,1959,N,N
10,6,0,4,FBS Independents,,Air Force,1960,N,N
11,2,0,9,SEC,,Alabama,1960,N,N
10,3,0,7,Border,,Arizona,1960,N,N
10,3,0,7,Border,,Arizona State,1960,N,N
11,3,0,8,Southwest,,Arkansas,1960,N,N
10,3,0,7,FBS Independents,,Army,1960,N,N
10,2,0,8,SEC,,Auburn,1960,N,N
11,3,0,8,Southwest,,Baylor,1960,N,N
10,7,0,3,FBS Independents,,Boston College,1960,N,N
10,6,0,4,FBS Independents,,Boston University,1960,N,N
9,6,0,3,Ivy,,Brown,1960,N,N
11,8,0,3,Skyline,,BYU,1960,N,N
10,8,0,2,AAWU,,California,1960,N,N
10,6,0,4,Missouri Valley,,Cincinnati,1960,N,N
10,4,0,6,ACC,,Clemson,1960,N,N
9,7,0,2,FBS Independents,,Colgate,1960,N,N
10,4,0,6,Big 8,,Colorado,1960,N,N
10,8,0,2,Skyline,,Colorado State,1960,N,N
9,6,0,3,Ivy,,Columbia,1960,N,N
9,7,0,2,Ivy,,Cornell,1960,N,N
9,4,0,5,Ivy,,Dartmouth,1960,N,N
8,5,0,3,Southern,,Davidson,1960,N,N
10,9,0,1,FBS Independents,,Dayton,1960,N,N
10,7,0,3,Skyline,,Denver,1960,N,N
9,2,0,7,FBS Independents,,Detroit Mercy,1960,N,N
11,3,0,8,ACC,,Duke,1960,N,N
11,2,0,9,SEC,,Florida,1960,N,N
10,6,0,4,FBS Independents,,Florida State,1960,N,N
10,4,0,6,Southern,,Furman,1960,N,N
9,3,0,6,Southern,,George Washington,1960,N,N
10,4,0,6,SEC,,Georgia,1960,N,N
10,5,0,5,SEC,,Georgia Tech,1960,N,N
10,10,0,0,Border,,Hardin-Simmons,1960,N,N
9,4,0,5,Ivy,,Harvard,1960,N,N
10,4,0,6,FBS Independents,,Holy Cross,1960,N,N
10,4,0,6,FBS Independents,,Houston,1960,N,N
10,9,0,1,FBS Independents,,Idaho,1960,N,N
9,4,0,5,Big Ten,,Illinois,1960,N,N
9,8,0,1,Big Ten,,Indiana,1960,N,N
9,1,0,8,Big Ten,,Iowa,1960,N,N
10,3,0,7,Big 8,,Iowa State,1960,N,N
10,3,0,7,Big 8,,Kansas,1960,N,N
10,9,0,1,Big 8,,Kansas State,1960,N,N
10,4,0,6,SEC,,Kentucky,1960,N,N
10,4,0,6,SEC,,LSU,1960,N,N
9,6,0,3,FBS Independents,,Marquette,1960,N,N
10,4,0,6,ACC,,Maryland,1960,N,N
10,2,0,8,FBS Independents,,Memphis,1960,N,N
10,4,0,6,FBS Independents,,Miami,1960,N,N
9,4,0,5,Big Ten,,Michigan,1960,N,N
9,2,0,7,Big Ten,,Michigan State,1960,N,N
10,2,0,8,Big Ten,,Minnesota,1960,Y,N
9,7,0,2,SEC,,Mississippi State,1960,Y,N
11,1,0,10,Big 8,,Missouri,1960,N,N
10,5,0,5,Skyline,,Montana,1960,N,N
11,2,0,9,FBS Independents,,Navy,1960,N,N
10,3,0,7,ACC,,NC State,1960,N,N
10,6,0,4,Big 8,,Nebraska,1960,N,N
10,5,0,5,Skyline,,New Mexico,1960,N,N
11,0,0,11,Border,,New Mexico State,1960,N,N
10,7,0,3,ACC,,North Carolina,1960,N,N
9,7,0,2,Missouri Valley,,North Texas,1960,N,N
9,4,0,5,Big Ten,,Northwestern,1960,N,N
10,8,0,2,FBS Independents,,Notre Dame,1960,N,N
9,2,0,7,Big Ten,,Ohio State,1960,N,N
10,6,0,4,Big 8,,Oklahoma,1960,N,N
10,7,0,3,Big 8,,Oklahoma State,1960,N,N
11,1,0,10,SEC,,Ole Miss,1960,N,N
11,3,0,8,FBS Independents,,Oregon,1960,N,N
10,4,0,6,FBS Independents,,Oregon State,1960,N,N
10,6,0,4,FBS Independents,,Pacific,1960,N,N
10,3,0,7,FBS Independents,,Penn State,1960,N,N
9,6,0,3,Ivy,,Pennsylvania,1960,N,N
10,5,0,5,FBS Independents,,Pittsburgh,1960,N,N
9,2,0,7,Ivy,,Princeton,1960,N,N
9,5,0,4,Big Ten,,Purdue,1960,N,N
11,4,0,7,Southwest,,Rice,1960,N,N
10,6,0,4,Southern,,Richmond,1960,N,N
9,1,0,8,FBS Independents,,Rutgers,1960,N,N
9,4,0,5,FBS Independents,,San Josï¿½ State,1960,N,N
10,10,0,0,Southwest,,SMU,1960,N,N
10,7,0,3,ACC,,South Carolina,1960,N,N
10,10,0,0,AAWU,,Stanford,1960,N,N
9,2,0,7,FBS Independents,,Syracuse,1960,N,N
10,5,0,5,Southwest,,TCU,1960,N,N
10,3,0,7,SEC,,Tennessee,1960,N,N
11,3,0,8,Southwest,,Texas,1960,N,N
10,8,0,2,Southwest,,Texas A&M,1960,N,N
10,6,0,4,Southwest,,Texas Tech,1960,N,N
11,3,0,8,Southern,,The Citadel,1960,N,N
10,7,0,3,SEC,,Tulane,1960,N,N
10,5,0,5,Missouri Valley,,Tulsa,1960,N,N
10,2,0,8,AAWU,,UCLA,1960,N,N
10,6,0,4,AAWU,,USC,1960,N,N
10,3,0,7,Skyline,,Utah,1960,N,N
11,2,0,9,Skyline,,Utah State,1960,N,N
10,5,0,5,Border,,UTEP,1960,N,N
10,7,0,3,SEC,,Vanderbilt,1960,N,N
10,8,0,2,FBS Independents,,Villanova,1960,N,N
10,10,0,0,ACC,,Virginia,1960,N,N
10,4,0,6,Southern,,Virginia Tech,1960,N,N
10,2,0,8,Southern,,VMI,1960,N,N
10,8,0,2,ACC,,Wake Forest,1960,N,N
11,1,0,10,AAWU,,Washington,1960,N,N
10,5,0,5,FBS Independents,,Washington State,1960,N,N
10,7,0,3,Border,,West Texas A&M,1960,N,N
10,10,0,0,Southern,,West Virginia,1960,N,N
10,2,0,8,Missouri Valley,,Wichita State,1960,N,N
10,8,0,2,Southern,,William & Mary,1960,N,N
9,5,0,4,Big Ten,,Wisconsin,1960,N,N
10,2,0,8,Skyline,,Wyoming,1960,N,N
10,5,0,5,FBS Independents,,Xavier,1960,N,N
9,0,0,9,Ivy,,Yale,1960,N,N
10,7,0,3,FBS Independents,,Air Force,1961,N,N
11,0,0,11,SEC,,Alabama,1961,Y,N
10,1,0,9,FBS Independents,,Arizona,1961,N,N
10,3,0,7,Border,,Arizona State,1961,N,N
11,3,0,8,Southwest,,Arkansas,1961,N,N
10,4,0,6,FBS Independents,,Army,1961,N,N
10,4,0,6,SEC,,Auburn,1961,N,N
11,5,0,6,Southwest,,Baylor,1961,N,N
10,6,0,4,FBS Independents,,Boston College,1961,N,N
9,5,0,4,FBS Independents,,Boston University,1961,N,N
9,9,0,0,Ivy,,Brown,1961,N,N
10,8,0,2,Skyline,,BYU,1961,N,N
10,8,0,2,AAWU,,California,1961,N,N
10,7,0,3,Missouri Valley,,Cincinnati,1961,N,N
10,5,0,5,ACC,,Clemson,1961,N,N
9,4,0,5,FBS Independents,,Colgate,1961,N,N
11,2,0,9,Big 8,,Colorado,1961,N,N
10,10,0,0,Skyline,,Colorado State,1961,N,N
9,3,0,6,Ivy,,Columbia,1961,N,N
9,6,0,3,Ivy,,Cornell,1961,N,N
9,3,0,6,Ivy,,Dartmouth,1961,N,N
8,4,0,4,Southern,,Davidson,1961,N,N
10,8,0,2,FBS Independents,,Dayton,1961,N,N
9,4,0,5,FBS Independents,,Detroit Mercy,1961,N,N
10,3,0,7,ACC,,Duke,1961,N,N
10,6,0,4,SEC,,Florida,1961,N,N
10,5,0,5,FBS Independents,,Florida State,1961,N,N
10,3,0,7,Southern,,Furman,1961,N,N
9,6,0,3,Southern,,George Washington,1961,N,N
10,7,0,3,SEC,,Georgia,1961,N,N
11,4,0,7,SEC,,Georgia Tech,1961,N,N
10,10,0,0,Border,,Hardin-Simmons,1961,N,N
9,3,0,6,Ivy,,Harvard,1961,N,N
10,3,0,7,FBS Independents,,Holy Cross,1961,N,N
10,4,0,6,FBS Independents,,Houston,1961,N,N
9,7,0,2,FBS Independents,,Idaho,1961,N,N
9,9,0,0,Big Ten,,Illinois,1961,N,N
9,7,0,2,Big Ten,,Indiana,1961,N,N
9,4,0,5,Big Ten,,Iowa,1961,N,N
10,5,0,5,Big 8,,Iowa State,1961,N,N
11,4,0,7,Big 8,,Kansas,1961,N,N
10,8,0,2,Big 8,,Kansas State,1961,N,N
10,5,0,5,SEC,,Kentucky,1961,N,N
11,1,0,10,SEC,,LSU,1961,N,N
10,3,0,7,ACC,,Maryland,1961,N,N
10,2,0,8,FBS Independents,,Memphis,1961,N,N
11,4,0,7,FBS Independents,,Miami,1961,N,N
9,3,0,6,Big Ten,,Michigan,1961,N,N
9,2,0,7,Big Ten,,Michigan State,1961,N,N
10,2,0,8,Big Ten,,Minnesota,1961,N,N
10,5,0,5,SEC,,Mississippi State,1961,N,N
10,3,0,7,Big 8,,Missouri,1961,N,N
8,6,0,2,Skyline,,Montana,1961,N,N
10,3,0,7,FBS Independents,,Navy,1961,N,N
10,6,0,4,ACC,,NC State,1961,N,N
10,7,0,3,Big 8,,Nebraska,1961,N,N
11,4,0,7,Skyline,,New Mexico,1961,N,N
10,4,0,6,Border,,New Mexico State,1961,N,N
10,5,0,5,ACC,,North Carolina,1961,N,N
10,5,0,5,Missouri Valley,,North Texas,1961,N,N
9,5,0,4,Big Ten,,Northwestern,1961,N,N
10,5,0,5,FBS Independents,,Notre Dame,1961,N,N
9,1,0,8,Big Ten,,Ohio State,1961,Y,N
10,5,0,5,Big 8,,Oklahoma,1961,N,N
10,6,0,4,Big 8,,Oklahoma State,1961,N,N
11,2,0,9,SEC,,Ole Miss,1961,N,N
10,6,0,4,FBS Independents,,Oregon,1961,N,N
10,5,0,5,FBS Independents,,Oregon State,1961,N,N
9,4,0,5,FBS Independents,,Pacific,1961,N,N
11,3,0,8,FBS Independents,,Penn State,1961,N,N
9,7,0,2,Ivy,,Pennsylvania,1961,N,N
10,7,0,3,FBS Independents,,Pittsburgh,1961,N,N
9,4,0,5,Ivy,,Princeton,1961,N,N
9,3,0,6,Big Ten,,Purdue,1961,N,N
11,4,0,7,Southwest,,Rice,1961,N,N
10,5,0,5,Southern,,Richmond,1961,N,N
9,0,0,9,FBS Independents,,Rutgers,1961,N,N
10,4,0,6,FBS Independents,,San Josï¿½ State,1961,N,N
10,7,0,3,Southwest,,SMU,1961,N,N
10,6,0,4,ACC,,South Carolina,1961,N,N
10,6,0,4,AAWU,,Stanford,1961,N,N
11,3,0,8,FBS Independents,,Syracuse,1961,N,N
10,6,0,4,Southwest,,TCU,1961,N,N
10,4,0,6,SEC,,Tennessee,1961,N,N
11,1,0,10,Southwest,,Texas,1961,N,N
10,6,0,4,Southwest,,Texas A&M,1961,N,N
10,6,0,4,Southwest,,Texas Tech,1961,N,N
10,3,0,7,Southern,,The Citadel,1961,N,N
10,8,0,2,SEC,,Tulane,1961,N,N
10,8,0,2,Missouri Valley,,Tulsa,1961,N,N
11,4,0,7,AAWU,,UCLA,1961,N,N
10,5,0,5,AAWU,,USC,1961,N,N
10,4,0,6,Skyline,,Utah,1961,N,N
11,1,0,10,Skyline,,Utah State,1961,N,N
10,7,0,3,Border,,UTEP,1961,N,N
10,8,0,2,SEC,,Vanderbilt,1961,N,N
10,2,0,8,FBS Independents,,Villanova,1961,N,N
10,6,0,4,ACC,,Virginia,1961,N,N
9,5,0,4,Southern,,Virginia Tech,1961,N,N
10,4,0,6,Southern,,VMI,1961,N,N
10,6,0,4,ACC,,Wake Forest,1961,N,N
10,5,0,5,AAWU,,Washington,1961,N,N
10,7,0,3,FBS Independents,,Washington State,1961,N,N
10,4,0,6,Border,,West Texas A&M,1961,N,N
10,6,0,4,Southern,,West Virginia,1961,N,N
11,3,0,8,Missouri Valley,,Wichita State,1961,N,N
10,9,0,1,Southern,,William & Mary,1961,N,N
9,3,0,6,Big Ten,,Wisconsin,1961,N,N
9,2,0,7,Skyline,,Wyoming,1961,N,N
10,4,0,6,FBS Independents,,Xavier,1961,N,N
9,5,0,4,Ivy,,Yale,1961,N,N
10,5,0,5,FBS Independents,,Air Force,1962,N,N
11,1,0,10,SEC,,Alabama,1962,N,N
10,5,0,5,Western Athletic,,Arizona,1962,N,N
10,3,0,7,Western Athletic,,Arizona State,1962,N,N
11,2,0,9,Southwest,,Arkansas,1962,N,N
10,4,0,6,FBS Independents,,Army,1962,N,N
10,4,0,6,SEC,,Auburn,1962,N,N
10,6,0,4,Southwest,,Baylor,1962,N,N
10,2,0,8,FBS Independents,,Boston College,1962,N,N
9,7,0,2,FBS Independents,,Boston University,1962,N,N
9,1,0,8,Mid-American,,Bowling Green,1962,N,N
9,8,0,1,Ivy,,Brown,1962,N,N
9,3,0,6,FBS Independents,,Buffalo,1962,N,N
10,6,0,4,Western Athletic,,BYU,1962,N,N
10,9,0,1,AAWU,,California,1962,N,N
10,8,0,2,Missouri Valley,,Cincinnati,1962,N,N
10,4,0,6,ACC,,Clemson,1962,N,N
9,5,0,4,FBS Independents,,Colgate,1962,N,N
10,8,0,2,Big 8,,Colorado,1962,N,N
10,10,0,0,FBS Independents,,Colorado State,1962,N,N
9,4,0,5,Ivy,,Columbia,1962,N,N
9,5,0,4,Ivy,,Cornell,1962,N,N
9,0,0,9,Ivy,,Dartmouth,1962,N,N
9,6,0,3,Southern,,Davidson,1962,N,N
10,8,0,2,FBS Independents,,Dayton,1962,N,N
9,8,0,1,FBS Independents,,Detroit Mercy,1962,N,N
10,2,0,8,ACC,,Duke,1962,N,N
11,4,0,7,SEC,,Florida,1962,N,N
10,3,0,7,FBS Independents,,Florida State,1962,N,N
10,6,0,4,Southern,,Furman,1962,N,N
10,7,0,3,Southern,,George Washington,1962,N,N
10,6,0,4,SEC,,Georgia,1962,N,N
11,4,0,7,SEC,,Georgia Tech,1962,N,N
10,9,0,1,FBS Independents,,Hardin-Simmons,1962,N,N
9,3,0,6,Ivy,,Harvard,1962,N,N
10,4,0,6,FBS Independents,,Holy Cross,1962,N,N
11,4,0,7,FBS Independents,,Houston,1962,N,N
9,6,0,3,FBS Independents,,Idaho,1962,N,N
9,7,0,2,Big Ten,,Illinois,1962,N,N
9,6,0,3,Big Ten,,Indiana,1962,N,N
9,5,0,4,Big Ten,,Iowa,1962,N,N
10,5,0,5,Big 8,,Iowa State,1962,N,N
10,3,0,7,Big 8,,Kansas,1962,N,N
10,10,0,0,Big 8,,Kansas State,1962,N,N
9,6,0,3,Mid-American,,Kent State,1962,N,N
10,6,0,4,SEC,,Kentucky,1962,N,N
10,4,0,6,FBS Independents,,Louisville,1962,N,N
11,2,0,9,SEC,,LSU,1962,N,N
10,6,0,4,Mid-American,,Marshall,1962,N,N
10,4,0,6,ACC,,Maryland,1962,N,N
9,1,0,8,FBS Independents,,Memphis,1962,N,N
11,4,0,7,FBS Independents,,Miami,1962,N,N
11,3,0,8,Mid-American,,Miami (OH),1962,N,N
9,7,0,2,Big Ten,,Michigan,1962,N,N
9,4,0,5,Big Ten,,Michigan State,1962,N,N
9,3,0,6,Big Ten,,Minnesota,1962,N,N
9,6,0,3,SEC,,Mississippi State,1962,N,N
11,2,0,9,Big 8,,Missouri,1962,N,N
10,5,0,5,FBS Independents,,Montana,1962,N,N
10,5,0,5,FBS Independents,,Navy,1962,N,N
10,6,0,4,ACC,,NC State,1962,N,N
11,2,0,9,Big 8,,Nebraska,1962,N,N
10,2,0,8,Western Athletic,,New Mexico,1962,N,N
10,6,0,4,FBS Independents,,New Mexico State,1962,N,N
10,7,0,3,ACC,,North Carolina,1962,N,N
10,4,0,6,Missouri Valley,,North Texas,1962,N,N
9,2,0,7,Big Ten,,Northwestern,1962,N,N
10,5,0,5,FBS Independents,,Notre Dame,1962,N,N
11,3,0,8,Mid-American,,Ohio,1962,N,N
9,3,0,6,Big Ten,,Ohio State,1962,N,N
11,3,0,8,Big 8,,Oklahoma,1962,N,N
10,6,0,4,Big 8,,Oklahoma State,1962,N,N
10,0,0,10,SEC,,Ole Miss,1962,N,N
10,3,0,7,FBS Independents,,Oregon,1962,N,N
11,2,0,9,FBS Independents,,Oregon State,1962,N,N
10,5,0,5,FBS Independents,,Pacific,1962,N,N
11,2,0,9,FBS Independents,,Penn State,1962,N,N
9,6,0,3,Ivy,,Pennsylvania,1962,N,N
10,5,0,5,FBS Independents,,Pittsburgh,1962,N,N
9,4,0,5,Ivy,,Princeton,1962,N,N
9,4,0,5,Big Ten,,Purdue,1962,N,N
10,7,0,3,Southwest,,Rice,1962,N,N
9,3,0,6,Southern,,Richmond,1962,N,N
10,5,0,5,FBS Independents,,Rutgers,1962,N,N
11,9,0,2,FBS Independents,,San Josï¿½ State,1962,N,N
10,8,0,2,Southwest,,SMU,1962,N,N
10,6,0,4,ACC,,South Carolina,1962,N,N
10,5,0,5,AAWU,,Stanford,1962,N,N
10,5,0,5,FBS Independents,,Syracuse,1962,N,N
10,4,0,6,Southwest,,TCU,1962,N,N
10,6,0,4,SEC,,Tennessee,1962,N,N
11,1,0,10,Southwest,,Texas,1962,N,N
10,7,0,3,Southwest,,Texas A&M,1962,N,N
10,9,0,1,Southwest,,Texas Tech,1962,N,N
10,7,0,3,Southern,,The Citadel,1962,N,N
9,6,0,3,Mid-American,,Toledo,1962,N,N
10,10,0,0,SEC,,Tulane,1962,N,N
10,5,0,5,Missouri Valley,,Tulsa,1962,N,N
10,6,0,4,AAWU,,UCLA,1962,N,N
11,0,0,11,AAWU,,USC,1962,Y,N
10,6,0,4,Western Athletic,,Utah,1962,N,N
10,2,0,8,FBS Independents,,Utah State,1962,N,N
9,5,0,4,FBS Independents,,UTEP,1962,N,N
10,9,0,1,SEC,,Vanderbilt,1962,N,N
10,3,0,7,FBS Independents,,Villanova,1962,N,N
10,5,0,5,ACC,,Virginia,1962,N,N
10,5,0,5,Southern,,Virginia Tech,1962,N,N
10,4,0,6,Southern,,VMI,1962,N,N
10,10,0,0,ACC,,Wake Forest,1962,N,N
10,3,0,7,AAWU,,Washington,1962,N,N
10,4,0,6,AAWU,,Washington State,1962,N,N
9,4,0,5,Mid-American,,Western Michigan,1962,N,N
11,2,0,9,FBS Independents,,West Texas A&M,1962,N,N
10,2,0,8,Southern,,West Virginia,1962,N,N
10,7,0,3,Missouri Valley,,Wichita State,1962,N,N
10,5,0,5,Southern,,William & Mary,1962,N,N
10,2,0,8,Big Ten,,Wisconsin,1962,N,N
10,5,0,5,Western Athletic,,Wyoming,1962,N,N
10,4,0,6,FBS Independents,,Xavier,1962,N,N
9,6,0,3,Ivy,,Yale,1962,N,N
11,4,0,7,FBS Independents,,Air Force,1963,N,N
11,2,0,9,SEC,,Alabama,1963,N,N
10,5,0,5,Western Athletic,,Arizona,1963,N,N
9,1,0,8,Western Athletic,,Arizona State,1963,N,N
10,5,0,5,Southwest,,Arkansas,1963,N,N
10,3,0,7,FBS Independents,,Army,1963,N,N
11,2,0,9,SEC,,Auburn,1963,N,N
11,3,0,8,Southwest,,Baylor,1963,N,N
9,3,0,6,FBS Independents,,Boston College,1963,N,N
8,7,0,1,FBS Independents,,Boston University,1963,N,N
10,2,0,8,Mid-American,,Bowling Green,1963,N,N
8,5,0,3,Ivy,,Brown,1963,N,N
9,3,0,6,FBS Independents,,Buffalo,1963,N,N
10,8,0,2,Western Athletic,,BYU,1963,N,N
10,6,0,4,AAWU,,California,1963,N,N
10,4,0,6,Missouri Valley,,Cincinnati,1963,N,N
10,5,0,5,ACC,,Clemson,1963,N,N
8,4,0,4,FBS Independents,,Colgate,1963,N,N
10,8,0,2,Big 8,,Colorado,1963,N,N
10,7,0,3,FBS Independents,,Colorado State,1963,N,N
9,4,0,5,Ivy,,Columbia,1963,N,N
9,4,0,5,Ivy,,Cornell,1963,N,N
9,2,0,7,Ivy,,Dartmouth,1963,N,N
8,7,0,1,Southern,,Davidson,1963,N,N
10,9,0,1,FBS Independents,,Dayton,1963,N,N
9,6,0,3,FBS Independents,,Detroit Mercy,1963,N,N
10,4,0,6,ACC,,Duke,1963,N,N
10,4,0,6,SEC,,Florida,1963,N,N
10,6,0,4,FBS Independents,,Florida State,1963,N,N
10,3,0,7,Southern,,Furman,1963,N,N
9,7,0,2,Southern,,George Washington,1963,N,N
10,5,0,5,SEC,,Georgia,1963,N,N
10,3,0,7,SEC,,Georgia Tech,1963,N,N
9,4,0,5,Ivy,,Harvard,1963,N,N
9,7,0,2,FBS Independents,,Holy Cross,1963,N,N
10,8,0,2,FBS Independents,,Houston,1963,N,N
9,4,0,5,FBS Independents,,Idaho,1963,N,N
10,1,0,9,Big Ten,,Illinois,1963,N,N
9,6,0,3,Big Ten,,Indiana,1963,N,N
8,4,0,4,Big Ten,,Iowa,1963,N,N
9,5,0,4,Big 8,,Iowa State,1963,N,N
10,5,0,5,Big 8,,Kansas,1963,N,N
9,7,0,2,Big 8,,Kansas State,1963,N,N
9,5,0,4,Mid-American,,Kent State,1963,N,N
10,6,0,4,SEC,,Kentucky,1963,N,N
9,8,0,1,FBS Independents,,Lehigh,1963,N,N
10,7,0,3,Missouri Valley,,Louisville,1963,N,N
11,4,0,7,SEC,,LSU,1963,N,N
10,4,0,6,Mid-American,,Marshall,1963,N,N
10,7,0,3,ACC,,Maryland,1963,N,N
10,1,0,9,FBS Independents,,Memphis,1963,N,N
10,7,0,3,FBS Independents,,Miami,1963,N,N
10,4,0,6,Mid-American,,Miami (OH),1963,N,N
9,6,0,3,Big Ten,,Michigan,1963,N,N
9,2,0,7,Big Ten,,Michigan State,1963,N,N
9,6,0,3,Big Ten,,Minnesota,1963,N,N
11,3,0,8,SEC,,Mississippi State,1963,N,N
10,3,0,7,Big 8,,Missouri,1963,N,N
11,2,0,9,FBS Independents,,Navy,1963,N,N
11,3,0,8,ACC,,NC State,1963,N,N
11,1,0,10,Big 8,,Nebraska,1963,N,N
10,4,0,6,Western Athletic,,New Mexico,1963,N,N
10,6,0,4,FBS Independents,,New Mexico State,1963,N,N
11,2,0,9,ACC,,North Carolina,1963,N,N
9,6,0,3,Missouri Valley,,North Texas,1963,N,N
9,4,0,5,Big Ten,,Northwestern,1963,N,N
9,7,0,2,FBS Independents,,Notre Dame,1963,N,N
10,4,0,6,Mid-American,,Ohio,1963,N,N
9,4,0,5,Big Ten,,Ohio State,1963,N,N
10,2,0,8,Big 8,,Oklahoma,1963,N,N
9,8,0,1,Big 8,,Oklahoma State,1963,N,N
10,1,0,9,SEC,,Ole Miss,1963,N,N
11,3,0,8,FBS Independents,,Oregon,1963,N,N
10,5,0,5,FBS Independents,,Oregon State,1963,N,N
10,8,0,2,FBS Independents,,Pacific,1963,N,N
10,3,0,7,FBS Independents,,Penn State,1963,N,N
9,6,0,3,Ivy,,Pennsylvania,1963,N,N
10,1,0,9,FBS Independents,,Pittsburgh,1963,N,N
9,2,0,7,Ivy,,Princeton,1963,N,N
9,4,0,5,Big Ten,,Purdue,1963,N,N
10,4,0,6,Southwest,,Rice,1963,N,N
10,7,0,3,Southern,,Richmond,1963,N,N
9,6,0,3,FBS Independents,,Rutgers,1963,N,N
10,5,0,5,FBS Independents,,San Josï¿½ State,1963,N,N
11,7,0,4,Southwest,,SMU,1963,N,N
10,8,0,2,ACC,,South Carolina,1963,N,N
9,3,0,6,FBS Independents,,Southern Mississippi,1963,N,N
10,7,0,3,AAWU,,Stanford,1963,N,N
10,2,0,8,FBS Independents,,Syracuse,1963,N,N
10,6,0,4,Southwest,,TCU,1963,N,N
10,5,0,5,SEC,,Tennessee,1963,N,N
11,0,0,11,Southwest,,Texas,1963,Y,N
10,7,0,3,Southwest,,Texas A&M,1963,N,N
10,5,0,5,Southwest,,Texas Tech,1963,N,N
10,6,0,4,Southern,,The Citadel,1963,N,N
9,7,0,2,Mid-American,,Toledo,1963,N,N
10,9,0,1,SEC,,Tulane,1963,N,N
10,5,0,5,Missouri Valley,,Tulsa,1963,N,N
10,8,0,2,AAWU,,UCLA,1963,N,N
10,3,0,7,AAWU,,USC,1963,N,N
10,6,0,4,Western Athletic,,Utah,1963,N,N
10,2,0,8,FBS Independents,,Utah State,1963,N,N
10,7,0,3,FBS Independents,,UTEP,1963,N,N
10,8,0,2,SEC,,Vanderbilt,1963,N,N
9,4,0,5,FBS Independents,,Villanova,1963,N,N
10,8,0,2,ACC,,Virginia,1963,N,N
10,2,0,8,Southern,,Virginia Tech,1963,N,N
10,5,0,5,Southern,,VMI,1963,N,N
10,9,0,1,ACC,,Wake Forest,1963,N,N
11,5,0,6,AAWU,,Washington,1963,N,N
10,6,0,4,AAWU,,Washington State,1963,N,N
9,7,0,2,Mid-American,,Western Michigan,1963,N,N
9,5,0,4,FBS Independents,,West Texas A&M,1963,N,N
10,6,0,4,Southern,,West Virginia,1963,N,N
9,2,0,7,Missouri Valley,,Wichita State,1963,N,N
10,6,0,4,Southern,,William & Mary,1963,N,N
9,4,0,5,Big Ten,,Wisconsin,1963,N,N
10,4,0,6,Western Athletic,,Wyoming,1963,N,N
10,5,0,5,FBS Independents,,Xavier,1963,N,N
9,3,0,6,Ivy,,Yale,1963,N,N
10,6,0,4,FBS Independents,,Air Force,1964,N,N
11,1,0,10,SEC,,Alabama,1964,Y,N
10,4,0,6,Western Athletic,,Arizona,1964,N,N
10,2,0,8,Western Athletic,,Arizona State,1964,N,N
11,0,0,11,Southwest,,Arkansas,1964,Y,N
10,6,0,4,FBS Independents,,Army,1964,N,N
10,4,0,6,SEC,,Auburn,1964,N,N
10,5,0,5,Southwest,,Baylor,1964,N,N
9,3,0,6,FBS Independents,,Boston College,1964,N,N
9,7,0,2,FBS Independents,,Boston University,1964,N,N
10,1,0,9,Mid-American,,Bowling Green,1964,N,N
9,4,0,5,Ivy,,Brown,1964,N,N
9,4,0,5,FBS Independents,,Buffalo,1964,N,N
10,6,0,4,Western Athletic,,BYU,1964,N,N
10,7,0,3,AAWU,,California,1964,N,N
10,2,0,8,Missouri Valley,,Cincinnati,1964,N,N
10,7,0,3,ACC,,Clemson,1964,N,N
9,2,0,7,FBS Independents,,Colgate,1964,N,N
10,8,0,2,Big 8,,Colorado,1964,N,N
11,6,0,5,FBS Independents,,Colorado State,1964,N,N
9,6,0,3,Ivy,,Columbia,1964,N,N
9,6,0,3,Ivy,,Cornell,1964,N,N
9,3,0,6,Ivy,,Dartmouth,1964,N,N
9,6,0,3,Southern,,Davidson,1964,N,N
10,7,0,3,FBS Independents,,Dayton,1964,N,N
10,7,0,3,FBS Independents,,Detroit Mercy,1964,N,N
10,5,0,5,ACC,,Duke,1964,N,N
10,3,0,7,SEC,,Florida,1964,N,N
11,1,0,10,FBS Independents,,Florida State,1964,N,N
10,7,0,3,Southern,,Furman,1964,N,N
9,4,0,5,Southern,,George Washington,1964,N,N
11,3,0,8,SEC,,Georgia,1964,N,N
10,3,0,7,FBS Independents,,Georgia Tech,1964,N,N
9,3,0,6,Ivy,,Harvard,1964,N,N
10,5,0,5,FBS Independents,,Holy Cross,1964,N,N
9,7,0,2,FBS Independents,,Houston,1964,N,N
10,6,0,4,FBS Independents,,Idaho,1964,N,N
9,3,0,6,Big Ten,,Illinois,1964,N,N
9,7,0,2,Big Ten,,Indiana,1964,N,N
9,6,0,3,Big Ten,,Iowa,1964,N,N
10,8,0,2,Big 8,,Iowa State,1964,N,N
10,4,0,6,Big 8,,Kansas,1964,N,N
10,7,0,3,Big 8,,Kansas State,1964,N,N
9,6,0,3,Mid-American,,Kent State,1964,N,N
10,5,0,5,SEC,,Kentucky,1964,N,N
9,7,0,2,FBS Independents,,Lehigh,1964,N,N
10,9,0,1,Missouri Valley,,Louisville,1964,N,N
11,3,0,8,SEC,,LSU,1964,N,N
10,3,0,7,Mid-American,,Marshall,1964,N,N
10,5,0,5,ACC,,Maryland,1964,N,N
9,4,0,5,FBS Independents,,Memphis,1964,N,N
10,6,0,4,FBS Independents,,Miami,1964,N,N
10,3,0,7,Mid-American,,Miami (OH),1964,N,N
10,1,0,9,Big Ten,,Michigan,1964,N,N
9,5,0,4,Big Ten,,Michigan State,1964,N,N
9,4,0,5,Big Ten,,Minnesota,1964,N,N
10,6,0,4,SEC,,Mississippi State,1964,N,N
10,3,0,7,Big 8,,Missouri,1964,N,N
10,6,0,4,FBS Independents,,Navy,1964,N,N
10,5,0,5,ACC,,NC State,1964,N,N
11,2,0,9,Big 8,,Nebraska,1964,N,N
11,2,0,9,Western Athletic,,New Mexico,1964,N,N
10,4,0,6,FBS Independents,,New Mexico State,1964,N,N
10,5,0,5,ACC,,North Carolina,1964,N,N
10,8,0,2,Missouri Valley,,North Texas,1964,N,N
9,6,0,3,Big Ten,,Northwestern,1964,N,N
10,1,0,9,FBS Independents,,Notre Dame,1964,Y,N
10,4,0,6,Mid-American,,Ohio,1964,N,N
9,2,0,7,Big Ten,,Ohio State,1964,N,N
11,5,0,6,Big 8,,Oklahoma,1964,N,N
10,6,0,4,Big 8,,Oklahoma State,1964,N,N
11,5,0,6,SEC,,Ole Miss,1964,N,N
10,3,0,7,AAWU,,Oregon,1964,N,N
11,3,0,8,AAWU,,Oregon State,1964,N,N
10,9,0,1,FBS Independents,,Pacific,1964,N,N
10,4,0,6,FBS Independents,,Penn State,1964,N,N
9,8,0,1,Ivy,,Pennsylvania,1964,N,N
10,6,0,4,FBS Independents,,Pittsburgh,1964,N,N
9,0,0,9,Ivy,,Princeton,1964,N,N
9,3,0,6,Big Ten,,Purdue,1964,N,N
10,6,0,4,Southwest,,Rice,1964,N,N
10,7,0,3,Southern,,Richmond,1964,N,N
9,3,0,6,FBS Independents,,Rutgers,1964,N,N
10,6,0,4,FBS Independents,,San Josï¿½ State,1964,N,N
10,9,0,1,Southwest,,SMU,1964,N,N
10,7,0,3,ACC,,South Carolina,1964,N,N
9,3,0,6,FBS Independents,,Southern Mississippi,1964,N,N
10,5,0,5,AAWU,,Stanford,1964,N,N
11,4,0,7,FBS Independents,,Syracuse,1964,N,N
10,6,0,4,Southwest,,TCU,1964,N,N
10,5,0,5,SEC,,Tennessee,1964,N,N
11,1,0,10,Southwest,,Texas,1964,N,N
10,9,0,1,Southwest,,Texas A&M,1964,N,N
11,4,0,7,Southwest,,Texas Tech,1964,N,N
10,6,0,4,Southern,,The Citadel,1964,N,N
10,8,0,2,Mid-American,,Toledo,1964,N,N
10,7,0,3,SEC,,Tulane,1964,N,N
11,2,0,9,Missouri Valley,,Tulsa,1964,N,N
10,6,0,4,AAWU,,UCLA,1964,N,N
10,3,0,7,AAWU,,USC,1964,N,N
11,2,0,9,Western Athletic,,Utah,1964,N,N
10,5,0,5,FBS Independents,,Utah State,1964,N,N
10,9,0,1,FBS Independents,,UTEP,1964,N,N
10,7,0,3,SEC,,Vanderbilt,1964,N,N
8,2,0,6,FBS Independents,,Villanova,1964,N,N
10,5,0,5,ACC,,Virginia,1964,N,N
10,4,0,6,Southern,,Virginia Tech,1964,N,N
10,9,0,1,Southern,,VMI,1964,N,N
10,5,0,5,ACC,,Wake Forest,1964,N,N
10,4,0,6,AAWU,,Washington,1964,N,N
10,6,0,4,AAWU,,Washington State,1964,N,N
9,6,0,3,Mid-American,,Western Michigan,1964,N,N
10,6,0,4,FBS Independents,,West Texas A&M,1964,N,N
11,4,0,7,Southern,,West Virginia,1964,N,N
10,6,0,4,Missouri Valley,,Wichita State,1964,N,N
10,6,0,4,Southern,,William & Mary,1964,N,N
9,6,0,3,Big Ten,,Wisconsin,1964,N,N
10,2,0,8,Western Athletic,,Wyoming,1964,N,N
10,6,0,4,FBS Independents,,Xavier,1964,N,N
9,3,0,6,Ivy,,Yale,1964,N,N
10,6,0,4,FBS Independents,,Air Force,1965,N,N
11,2,0,9,SEC,,Alabama,1965,Y,N
10,7,0,3,Western Athletic,,Arizona,1965,N,N
10,4,0,6,Western Athletic,,Arizona State,1965,N,N
11,1,0,10,Southwest,,Arkansas,1965,N,N
10,6,0,4,FBS Independents,,Army,1965,N,N
11,5,0,6,SEC,,Auburn,1965,N,N
10,5,0,5,Southwest,,Baylor,1965,N,N
10,4,0,6,FBS Independents,,Boston College,1965,N,N
9,2,0,7,Mid-American,,Bowling Green,1965,N,N
9,7,0,2,Ivy,,Brown,1965,N,N
10,5,0,5,FBS Independents,,Buffalo,1965,N,N
10,4,0,6,Western Athletic,,BYU,1965,N,N
10,5,0,5,AAWU,,California,1965,N,N
10,5,0,5,Missouri Valley,,Cincinnati,1965,N,N
10,5,0,5,ACC,,Clemson,1965,N,N
10,3,0,7,FBS Independents,,Colgate,1965,N,N
10,3,0,7,Big 8,,Colorado,1965,N,N
10,6,0,4,FBS Independents,,Colorado State,1965,N,N
9,7,0,2,Ivy,,Columbia,1965,N,N
9,5,0,4,Ivy,,Cornell,1965,N,N
9,0,0,9,Ivy,,Dartmouth,1965,N,N
10,4,0,6,Southern,,Davidson,1965,N,N
10,8,0,2,FBS Independents,,Dayton,1965,N,N
10,4,0,6,ACC,,Duke,1965,N,N
10,1,0,9,Southern,,East Carolina,1965,N,N
11,4,0,7,SEC,,Florida,1965,N,N
10,6,0,4,FBS Independents,,Florida State,1965,N,N
10,5,0,5,Southern,,Furman,1965,N,N
10,5,0,5,Southern,,George Washington,1965,N,N
10,4,0,6,SEC,,Georgia,1965,N,N
11,3,0,8,FBS Independents,,Georgia Tech,1965,N,N
9,2,0,7,Ivy,,Harvard,1965,N,N
10,8,0,2,FBS Independents,,Holy Cross,1965,N,N
10,5,0,5,FBS Independents,,Houston,1965,N,N
10,4,0,6,Big Ten,,Illinois,1965,N,N
10,8,0,2,Big Ten,,Indiana,1965,N,N
10,9,0,1,Big Ten,,Iowa,1965,N,N
10,4,0,6,Big 8,,Iowa State,1965,N,N
10,8,0,2,Big 8,,Kansas,1965,N,N
10,10,0,0,Big 8,,Kansas State,1965,N,N
10,4,0,6,Mid-American,,Kent State,1965,N,N
10,4,0,6,SEC,,Kentucky,1965,N,N
9,8,0,1,FBS Independents,,Lehigh,1965,N,N
10,4,0,6,Missouri Valley,,Louisville,1965,N,N
11,3,0,8,SEC,,LSU,1965,N,N
10,5,0,5,Mid-American,,Marshall,1965,N,N
10,6,0,4,ACC,,Maryland,1965,N,N
10,5,0,5,FBS Independents,,Memphis,1965,N,N
10,5,0,5,FBS Independents,,Miami,1965,N,N
10,3,0,7,Mid-American,,Miami (OH),1965,N,N
10,6,0,4,Big Ten,,Michigan,1965,N,N
11,1,0,10,Big Ten,,Michigan State,1965,Y,N
10,4,0,6,Big Ten,,Minnesota,1965,N,N
10,6,0,4,SEC,,Mississippi State,1965,N,N
11,3,0,8,Big 8,,Missouri,1965,N,N
10,4,0,6,FBS Independents,,Navy,1965,N,N
10,4,0,6,ACC,,NC State,1965,N,N
11,1,0,10,Big 8,,Nebraska,1965,N,N
10,7,0,3,Western Athletic,,New Mexico,1965,N,N
10,2,0,8,FBS Independents,,New Mexico State,1965,N,N
10,6,0,4,ACC,,North Carolina,1965,N,N
10,7,0,3,Missouri Valley,,North Texas,1965,N,N
10,6,0,4,Big Ten,,Northwestern,1965,N,N
10,2,0,8,FBS Independents,,Notre Dame,1965,N,N
10,10,0,0,Mid-American,,Ohio,1965,N,N
9,2,0,7,Big Ten,,Ohio State,1965,N,N
10,7,0,3,Big 8,,Oklahoma,1965,N,N
10,7,0,3,Big 8,,Oklahoma State,1965,N,N
11,4,0,7,SEC,,Ole Miss,1965,N,N
10,6,0,4,AAWU,,Oregon,1965,N,N
10,5,0,5,AAWU,,Oregon State,1965,N,N
9,8,0,1,FBS Independents,,Pacific,1965,N,N
10,5,0,5,FBS Independents,,Penn State,1965,N,N
9,5,0,4,Ivy,,Pennsylvania,1965,N,N
10,7,0,3,FBS Independents,,Pittsburgh,1965,N,N
9,1,0,8,Ivy,,Princeton,1965,N,N
10,2,0,8,Big Ten,,Purdue,1965,N,N
10,4,0,6,FBS Independents,,Quantico Marines,1965,N,N
10,8,0,2,Southwest,,Rice,1965,N,N
10,10,0,0,Southern,,Richmond,1965,N,N
9,6,0,3,FBS Independents,,Rutgers,1965,N,N
10,5,0,5,FBS Independents,,San Josï¿½ State,1965,N,N
10,6,0,4,Southwest,,SMU,1965,N,N
10,5,0,5,ACC,,South Carolina,1965,N,N
9,2,0,7,FBS Independents,,Southern Mississippi,1965,N,N
10,4,0,6,AAWU,,Stanford,1965,N,N
10,3,0,7,FBS Independents,,Syracuse,1965,N,N
11,5,0,6,Southwest,,TCU,1965,N,N
11,2,0,9,SEC,,Tennessee,1965,N,N
10,4,0,6,Southwest,,Texas,1965,N,N
10,7,0,3,Southwest,,Texas A&M,1965,N,N
11,3,0,8,Southwest,,Texas Tech,1965,N,N
10,8,0,2,Southern,,The Citadel,1965,N,N
10,5,0,5,Mid-American,,Toledo,1965,N,N
10,8,0,2,SEC,,Tulane,1965,N,N
11,3,0,8,Missouri Valley,,Tulsa,1965,N,N
11,2,0,9,AAWU,,UCLA,1965,N,N
10,3,0,7,AAWU,,USC,1965,N,N
10,7,0,3,Western Athletic,,Utah,1965,N,N
10,2,0,8,FBS Independents,,Utah State,1965,N,N
11,3,0,8,FBS Independents,,UTEP,1965,N,N
10,8,0,2,SEC,,Vanderbilt,1965,N,N
9,8,0,1,FBS Independents,,Villanova,1965,N,N
10,6,0,4,ACC,,Virginia,1965,N,N
10,3,0,7,FBS Independents,,Virginia Tech,1965,N,N
10,7,0,3,Southern,,VMI,1965,N,N
10,7,0,3,ACC,,Wake Forest,1965,N,N
10,5,0,5,AAWU,,Washington,1965,N,N
10,3,0,7,AAWU,,Washington State,1965,N,N
9,3,0,6,Mid-American,,Western Michigan,1965,N,N
10,4,0,6,FBS Independents,,West Texas A&M,1965,N,N
10,4,0,6,Southern,,West Virginia,1965,N,N
9,7,0,2,Missouri Valley,,Wichita State,1965,N,N
10,4,0,6,Southern,,William & Mary,1965,N,N
10,8,0,2,Big Ten,,Wisconsin,1965,N,N
10,4,0,6,Western Athletic,,Wyoming,1965,N,N
10,2,0,8,FBS Independents,,Xavier,1965,N,N
9,6,0,3,Ivy,,Yale,1965,N,N
10,6,0,4,FBS Independents,,Air Force,1966,N,N
11,0,0,11,SEC,,Alabama,1966,N,N
10,7,0,3,Western Athletic,,Arizona,1966,N,N
10,5,0,5,Western Athletic,,Arizona State,1966,N,N
10,2,0,8,Southwest,,Arkansas,1966,N,N
10,2,0,8,FBS Independents,,Army,1966,N,N
10,6,0,4,SEC,,Auburn,1966,N,N
10,5,0,5,Southwest,,Baylor,1966,N,N
10,6,0,4,FBS Independents,,Boston College,1966,N,N
9,3,0,6,Mid-American,,Bowling Green,1966,N,N
9,8,0,1,Ivy,,Brown,1966,N,N
10,5,0,5,FBS Independents,,Buffalo,1966,N,N
10,2,0,8,Western Athletic,,BYU,1966,N,N
10,7,0,3,AAWU,,California,1966,N,N
10,7,0,3,Missouri Valley,,Cincinnati,1966,N,N
10,4,0,6,ACC,,Clemson,1966,N,N
10,2,0,8,FBS Independents,,Colgate,1966,N,N
10,3,0,7,Big 8,,Colorado,1966,N,N
10,3,0,7,FBS Independents,,Colorado State,1966,N,N
9,7,0,2,Ivy,,Columbia,1966,N,N
9,3,0,6,Ivy,,Cornell,1966,N,N
9,2,0,7,Ivy,,Dartmouth,1966,N,N
9,5,0,4,Southern,,Davidson,1966,N,N
10,2,0,8,FBS Independents,,Dayton,1966,N,N
10,5,0,5,ACC,,Duke,1966,N,N
10,5,0,5,Southern,,East Carolina,1966,N,N
11,2,0,9,SEC,,Florida,1966,N,N
11,5,0,6,FBS Independents,,Florida State,1966,N,N
10,8,0,2,Southern,,Furman,1966,N,N
10,6,0,4,Southern,,George Washington,1966,N,N
11,1,0,10,SEC,,Georgia,1966,N,N
11,2,0,9,FBS Independents,,Georgia Tech,1966,N,N
9,1,0,8,Ivy,,Harvard,1966,N,N
10,3,0,7,FBS Independents,,Holy Cross,1966,N,N
10,2,0,8,FBS Independents,,Houston,1966,N,N
10,6,0,4,Big Ten,,Illinois,1966,N,N
10,9,0,1,Big Ten,,Indiana,1966,N,N
10,8,0,2,Big Ten,,Iowa,1966,N,N
10,6,0,4,Big 8,,Iowa State,1966,N,N
10,7,0,3,Big 8,,Kansas,1966,N,N
10,10,0,0,Big 8,,Kansas State,1966,N,N
10,6,0,4,Mid-American,,Kent State,1966,N,N
10,6,0,4,SEC,,Kentucky,1966,N,N
10,4,0,6,Missouri Valley,,Louisville,1966,N,N
10,5,0,5,SEC,,LSU,1966,N,N
10,8,0,2,Mid-American,,Marshall,1966,N,N
10,6,0,4,ACC,,Maryland,1966,N,N
9,2,0,7,FBS Independents,,Memphis,1966,N,N
11,2,0,9,FBS Independents,,Miami,1966,N,N
10,1,0,9,Mid-American,,Miami (OH),1966,N,N
10,4,0,6,Big Ten,,Michigan,1966,N,N
10,1,0,9,Big Ten,,Michigan State,1966,Y,N
10,5,0,5,Big Ten,,Minnesota,1966,N,N
10,8,0,2,SEC,,Mississippi State,1966,N,N
10,4,0,6,Big 8,,Missouri,1966,N,N
10,6,0,4,FBS Independents,,Navy,1966,N,N
10,5,0,5,ACC,,NC State,1966,N,N
11,2,0,9,Big 8,,Nebraska,1966,N,N
10,8,0,2,Western Athletic,,New Mexico,1966,N,N
10,3,0,7,FBS Independents,,New Mexico State,1966,N,N
10,8,0,2,ACC,,North Carolina,1966,N,N
10,2,0,8,Missouri Valley,,North Texas,1966,N,N
10,6,0,4,Big Ten,,Northwestern,1966,N,N
10,0,0,10,FBS Independents,,Notre Dame,1966,Y,N
10,5,0,5,Mid-American,,Ohio,1966,N,N
9,5,0,4,Big Ten,,Ohio State,1966,N,N
10,4,0,6,Big 8,,Oklahoma,1966,N,N
10,6,0,4,Big 8,,Oklahoma State,1966,N,N
11,3,0,8,SEC,,Ole Miss,1966,N,N
10,7,0,3,AAWU,,Oregon,1966,N,N
10,3,0,7,AAWU,,Oregon State,1966,N,N
11,7,0,4,FBS Independents,,Pacific,1966,N,N
10,5,0,5,FBS Independents,,Penn State,1966,N,N
9,7,0,2,Ivy,,Pennsylvania,1966,N,N
10,9,0,1,FBS Independents,,Pittsburgh,1966,N,N
9,2,0,7,Ivy,,Princeton,1966,N,N
11,2,0,9,Big Ten,,Purdue,1966,N,N
10,8,0,2,Southwest,,Rice,1966,N,N
10,8,0,2,Southern,,Richmond,1966,N,N
9,4,0,5,FBS Independents,,Rutgers,1966,N,N
10,7,0,3,FBS Independents,,San Josï¿½ State,1966,N,N
11,3,0,8,Southwest,,SMU,1966,N,N
10,9,0,1,ACC,,South Carolina,1966,N,N
10,4,0,6,FBS Independents,,Southern Mississippi,1966,N,N
10,5,0,5,AAWU,,Stanford,1966,N,N
11,3,0,8,FBS Independents,,Syracuse,1966,N,N
9,5,0,4,FBS Independents,,Tampa,1966,N,N
10,8,0,2,Southwest,,TCU,1966,N,N
11,3,0,8,SEC,,Tennessee,1966,N,N
11,4,0,7,Southwest,,Texas,1966,N,N
10,5,0,5,Southwest,,Texas A&M,1966,N,N
10,6,0,4,Southwest,,Texas Tech,1966,N,N
10,6,0,4,Southern,,The Citadel,1966,N,N
10,8,0,2,Mid-American,,Toledo,1966,N,N
10,5,0,5,FBS Independents,,Tulane,1966,N,N
10,4,0,6,Missouri Valley,,Tulsa,1966,N,N
10,1,0,9,AAWU,,UCLA,1966,N,N
11,4,0,7,AAWU,,USC,1966,N,N
10,5,0,5,Western Athletic,,Utah,1966,N,N
10,6,0,4,FBS Independents,,Utah State,1966,N,N
10,4,0,6,FBS Independents,,UTEP,1966,N,N
10,9,0,1,SEC,,Vanderbilt,1966,N,N
9,3,0,6,FBS Independents,,Villanova,1966,N,N
10,6,0,4,ACC,,Virginia,1966,N,N
11,3,0,8,FBS Independents,,Virginia Tech,1966,N,N
10,8,0,2,Southern,,VMI,1966,N,N
10,7,0,3,ACC,,Wake Forest,1966,N,N
10,4,0,6,AAWU,,Washington,1966,N,N
10,7,0,3,AAWU,,Washington State,1966,N,N
10,3,0,7,Mid-American,,Western Michigan,1966,N,N
10,3,0,7,FBS Independents,,West Texas A&M,1966,N,N
10,6,0,4,Southern,,West Virginia,1966,N,N
10,8,0,2,Missouri Valley,,Wichita State,1966,N,N
10,5,0,5,Southern,,William & Mary,1966,N,N
10,7,0,3,Big Ten,,Wisconsin,1966,N,N
11,1,0,10,Western Athletic,,Wyoming,1966,N,N
10,6,0,4,FBS Independents,,Xavier,1966,N,N
9,5,0,4,Ivy,,Yale,1966,N,N
10,7,0,3,FBS Independents,,Air Force,1967,N,N
11,3,0,8,SEC,,Alabama,1967,N,N
10,7,0,3,Western Athletic,,Arizona,1967,N,N
10,2,0,8,Western Athletic,,Arizona State,1967,N,N
10,5,0,5,Southwest,,Arkansas,1967,N,N
10,2,0,8,FBS Independents,,Army,1967,N,N
10,4,0,6,SEC,,Auburn,1967,N,N
10,9,0,1,Southwest,,Baylor,1967,N,N
10,6,0,4,FBS Independents,,Boston College,1967,N,N
10,4,0,6,Mid-American,,Bowling Green,1967,N,N
9,6,0,3,Ivy,,Brown,1967,N,N
10,4,0,6,FBS Independents,,Buffalo,1967,N,N
10,4,0,6,Western Athletic,,BYU,1967,N,N
10,5,0,5,AAWU,,California,1967,N,N
9,6,0,3,Missouri Valley,,Cincinnati,1967,N,N
10,4,0,6,ACC,,Clemson,1967,N,N
10,8,0,2,FBS Independents,,Colgate,1967,N,N
11,2,0,9,Big 8,,Colorado,1967,N,N
10,5,0,5,FBS Independents,,Colorado State,1967,N,N
9,7,0,2,Ivy,,Columbia,1967,N,N
9,3,0,6,Ivy,,Cornell,1967,N,N
9,2,0,7,Ivy,,Dartmouth,1967,N,N
9,5,0,4,Southern,,Davidson,1967,N,N
10,3,0,7,FBS Independents,,Dayton,1967,N,N
10,6,0,4,ACC,,Duke,1967,N,N
10,2,0,8,Southern,,East Carolina,1967,N,N
10,4,0,6,SEC,,Florida,1967,N,N
11,3,0,8,FBS Independents,,Florida State,1967,N,N
10,5,0,5,Southern,,Furman,1967,N,N
11,4,0,7,SEC,,Georgia,1967,N,N
10,6,0,4,FBS Independents,,Georgia Tech,1967,N,N
9,3,0,6,Ivy,,Harvard,1967,N,N
10,5,0,5,FBS Independents,,Holy Cross,1967,N,N
10,3,0,7,FBS Independents,,Houston,1967,N,N
10,6,0,4,Big Ten,,Illinois,1967,N,N
11,2,0,9,Big Ten,,Indiana,1967,N,N
10,8,0,2,Big Ten,,Iowa,1967,N,N
10,8,0,2,Big 8,,Iowa State,1967,N,N
10,5,0,5,Big 8,,Kansas,1967,N,N
10,9,0,1,Big 8,,Kansas State,1967,N,N
10,5,0,5,Mid-American,,Kent State,1967,N,N
10,8,0,2,SEC,,Kentucky,1967,N,N
10,5,0,5,Missouri Valley,,Louisville,1967,N,N
11,3,0,8,SEC,,LSU,1967,N,N
10,10,0,0,Mid-American,,Marshall,1967,N,N
9,9,0,0,ACC,,Maryland,1967,N,N
9,3,0,6,FBS Independents,,Memphis,1967,N,N
11,4,0,7,FBS Independents,,Miami,1967,N,N
10,4,0,6,Mid-American,,Miami (OH),1967,N,N
10,6,0,4,Big Ten,,Michigan,1967,N,N
10,7,0,3,Big Ten,,Michigan State,1967,N,N
10,2,0,8,Big Ten,,Minnesota,1967,N,N
10,9,0,1,SEC,,Mississippi State,1967,N,N
10,3,0,7,Big 8,,Missouri,1967,N,N
10,5,0,5,FBS Independents,,Navy,1967,N,N
11,2,0,9,ACC,,NC State,1967,N,N
10,4,0,6,Big 8,,Nebraska,1967,N,N
10,9,0,1,Western Athletic,,New Mexico,1967,N,N
10,3,0,7,FBS Independents,,New Mexico State,1967,N,N
10,8,0,2,ACC,,North Carolina,1967,N,N
9,1,0,8,Missouri Valley,,North Texas,1967,N,N
10,7,0,3,Big Ten,,Northwestern,1967,N,N
10,2,0,8,FBS Independents,,Notre Dame,1967,N,N
10,5,0,5,Mid-American,,Ohio,1967,N,N
9,3,0,6,Big Ten,,Ohio State,1967,N,N
11,1,0,10,Big 8,,Oklahoma,1967,N,N
10,6,0,4,Big 8,,Oklahoma State,1967,N,N
11,5,0,6,SEC,,Ole Miss,1967,N,N
10,8,0,2,AAWU,,Oregon,1967,N,N
10,2,0,8,AAWU,,Oregon State,1967,N,N
9,5,0,4,FBS Independents,,Pacific,1967,N,N
11,2,0,9,FBS Independents,,Penn State,1967,N,N
9,6,0,3,Ivy,,Pennsylvania,1967,N,N
10,9,0,1,FBS Independents,,Pittsburgh,1967,N,N
9,3,0,6,Ivy,,Princeton,1967,N,N
10,2,0,8,Big Ten,,Purdue,1967,N,N
10,6,0,4,Southwest,,Rice,1967,N,N
10,5,0,5,Southern,,Richmond,1967,N,N
9,5,0,4,FBS Independents,,Rutgers,1967,N,N
9,7,0,2,FBS Independents,,San Josï¿½ State,1967,N,N
10,7,0,3,Southwest,,SMU,1967,N,N
10,5,0,5,ACC,,South Carolina,1967,N,N
9,3,0,6,FBS Independents,,Southern Mississippi,1967,N,N
10,5,0,5,AAWU,,Stanford,1967,N,N
10,2,0,8,FBS Independents,,Syracuse,1967,N,N
9,7,0,2,FBS Independents,,Tampa,1967,N,N
10,6,0,4,Southwest,,TCU,1967,N,N
11,2,0,9,SEC,,Tennessee,1967,N,N
10,4,0,6,Southwest,,Texas,1967,N,N
11,4,0,7,Southwest,,Texas A&M,1967,N,N
10,4,0,6,Southwest,,Texas Tech,1967,N,N
10,5,0,5,Southern,,The Citadel,1967,N,N
10,1,0,9,Mid-American,,Toledo,1967,N,N
10,7,0,3,FBS Independents,,Tulane,1967,N,N
10,3,0,7,Missouri Valley,,Tulsa,1967,N,N
10,3,0,7,AAWU,,UCLA,1967,N,N
11,1,0,10,AAWU,,USC,1967,Y,N
11,7,0,4,Western Athletic,,Utah,1967,N,N
10,2,0,8,FBS Independents,,Utah State,1967,N,N
10,2,0,8,FBS Independents,,UTEP,1967,N,N
10,7,0,3,SEC,,Vanderbilt,1967,N,N
10,6,0,4,FBS Independents,,Villanova,1967,N,N
10,5,0,5,ACC,,Virginia,1967,N,N
10,3,0,7,FBS Independents,,Virginia Tech,1967,N,N
10,4,0,6,Southern,,VMI,1967,N,N
10,6,0,4,ACC,,Wake Forest,1967,N,N
10,5,0,5,AAWU,,Washington,1967,N,N
10,8,0,2,AAWU,,Washington State,1967,N,N
9,4,0,5,Mid-American,,Western Michigan,1967,N,N
11,3,0,8,FBS Independents,,West Texas A&M,1967,N,N
10,4,0,6,Southern,,West Virginia,1967,N,N
10,8,0,2,Missouri Valley,,Wichita State,1967,N,N
10,5,0,5,Southern,,William & Mary,1967,N,N
10,10,0,0,Big Ten,,Wisconsin,1967,N,N
11,1,0,10,Western Athletic,,Wyoming,1967,N,N
10,4,0,6,FBS Independents,,Xavier,1967,N,N
9,1,0,8,Ivy,,Yale,1967,N,N
10,3,0,7,FBS Independents,,Air Force,1968,N,N
11,3,0,8,SEC,,Alabama,1968,N,N
11,3,0,8,Western Athletic,,Arizona,1968,N,N
10,2,0,8,Western Athletic,,Arizona State,1968,N,N
11,1,0,10,Southwest,,Arkansas,1968,N,N
10,3,0,7,FBS Independents,,Army,1968,N,N
11,4,0,7,SEC,,Auburn,1968,N,N
10,7,0,3,Southwest,,Baylor,1968,N,N
9,3,0,6,FBS Independents,,Boston College,1968,N,N
10,3,0,7,Mid-American,,Bowling Green,1968,N,N
9,7,0,2,Ivy,,Brown,1968,N,N
10,3,0,7,FBS Independents,,Buffalo,1968,N,N
10,8,0,2,Western Athletic,,BYU,1968,N,N
11,3,0,8,Pac-8,,California,1968,N,N
10,4,0,6,Missouri Valley,,Cincinnati,1968,N,N
10,5,0,5,ACC,,Clemson,1968,N,N
10,5,0,5,FBS Independents,,Colgate,1968,N,N
10,6,0,4,Big 8,,Colorado,1968,N,N
10,8,0,2,Western Athletic,,Colorado State,1968,N,N
9,7,0,2,Ivy,,Columbia,1968,N,N
9,6,0,3,Ivy,,Cornell,1968,N,N
9,5,0,4,Ivy,,Dartmouth,1968,N,N
9,6,0,3,Southern,,Davidson,1968,N,N
10,5,0,5,FBS Independents,,Dayton,1968,N,N
10,6,0,4,ACC,,Duke,1968,N,N
10,6,0,4,Southern,,East Carolina,1968,N,N
10,3,0,7,SEC,,Florida,1968,N,N
11,3,0,8,FBS Independents,,Florida State,1968,N,N
10,9,0,1,Southern,,Furman,1968,N,N
11,2,0,9,SEC,,Georgia,1968,N,N
10,6,0,4,FBS Independents,,Georgia Tech,1968,N,N
9,1,0,8,Ivy,,Harvard,1968,N,N
10,6,0,4,FBS Independents,,Holy Cross,1968,N,N
10,2,0,8,FBS Independents,,Houston,1968,N,N
10,9,0,1,Big Ten,,Illinois,1968,N,N
10,4,0,6,Big Ten,,Indiana,1968,N,N
10,5,0,5,Big Ten,,Iowa,1968,N,N
10,7,0,3,Big 8,,Iowa State,1968,N,N
11,2,0,9,Big 8,,Kansas,1968,N,N
10,6,0,4,Big 8,,Kansas State,1968,N,N
10,9,0,1,Mid-American,,Kent State,1968,N,N
10,7,0,3,SEC,,Kentucky,1968,N,N
10,5,0,5,Missouri Valley,,Louisville,1968,N,N
11,3,0,8,SEC,,LSU,1968,N,N
10,10,0,0,Mid-American,,Marshall,1968,N,N
10,8,0,2,ACC,,Maryland,1968,N,N
10,4,0,6,Missouri Valley,,Memphis,1968,N,N
10,5,0,5,FBS Independents,,Miami,1968,N,N
10,3,0,7,Mid-American,,Miami (OH),1968,N,N
10,2,0,8,Big Ten,,Michigan,1968,N,N
10,5,0,5,Big Ten,,Michigan State,1968,N,N
10,4,0,6,Big Ten,,Minnesota,1968,N,N
10,9,0,1,SEC,,Mississippi State,1968,N,N
11,3,0,8,Big 8,,Missouri,1968,N,N
10,8,0,2,FBS Independents,,Navy,1968,N,N
10,4,0,6,ACC,,NC State,1968,N,N
10,4,0,6,Big 8,,Nebraska,1968,N,N
10,10,0,0,Western Athletic,,New Mexico,1968,N,N
10,5,0,5,FBS Independents,,New Mexico State,1968,N,N
10,7,0,3,ACC,,North Carolina,1968,N,N
10,8,0,2,FBS Independents,,Northern Illinois,1968,N,N
10,2,0,8,Missouri Valley,,North Texas,1968,N,N
10,9,0,1,Big Ten,,Northwestern,1968,N,N
10,2,0,8,FBS Independents,,Notre Dame,1968,N,N
11,1,0,10,Mid-American,,Ohio,1968,N,N
10,0,0,10,Big Ten,,Ohio State,1968,Y,N
11,4,0,7,Big 8,,Oklahoma,1968,N,N
10,7,0,3,Big 8,,Oklahoma State,1968,N,N
11,4,0,7,SEC,,Ole Miss,1968,N,N
10,6,0,4,Pac-8,,Oregon,1968,N,N
10,3,0,7,Pac-8,,Oregon State,1968,N,N
10,4,0,6,FBS Independents,,Pacific,1968,N,N
11,0,0,11,FBS Independents,,Penn State,1968,N,N
9,2,0,7,Ivy,,Pennsylvania,1968,N,N
10,9,0,1,FBS Independents,,Pittsburgh,1968,N,N
9,5,0,4,Ivy,,Princeton,1968,N,N
10,2,0,8,Big Ten,,Purdue,1968,N,N
10,9,0,1,Southwest,,Rice,1968,N,N
11,3,0,8,Southern,,Richmond,1968,N,N
10,2,0,8,FBS Independents,,Rutgers,1968,N,N
10,7,0,3,FBS Independents,,San Josï¿½ State,1968,N,N
11,3,0,8,Southwest,,SMU,1968,N,N
10,6,0,4,ACC,,South Carolina,1968,N,N
10,6,0,4,FBS Independents,,Southern Mississippi,1968,N,N
10,3,0,7,Pac-8,,Stanford,1968,N,N
10,4,0,6,FBS Independents,,Syracuse,1968,N,N
10,3,0,7,FBS Independents,,Tampa,1968,N,N
10,7,0,3,Southwest,,TCU,1968,N,N
11,3,0,8,SEC,,Tennessee,1968,N,N
11,2,0,9,Southwest,,Texas,1968,N,N
10,7,0,3,Southwest,,Texas A&M,1968,N,N
10,4,0,6,Southwest,,Texas Tech,1968,N,N
10,5,0,5,Southern,,The Citadel,1968,N,N
10,5,0,5,Mid-American,,Toledo,1968,N,N
10,8,0,2,FBS Independents,,Tulane,1968,N,N
10,7,0,3,Missouri Valley,,Tulsa,1968,N,N
10,7,0,3,Pac-8,,UCLA,1968,N,N
11,2,0,9,Pac-8,,USC,1968,N,N
10,7,0,3,Western Athletic,,Utah,1968,N,N
10,3,0,7,FBS Independents,,Utah State,1968,N,N
10,6,0,4,Western Athletic,,UTEP,1968,N,N
10,5,0,5,SEC,,Vanderbilt,1968,N,N
10,4,0,6,FBS Independents,,Villanova,1968,N,N
10,3,0,7,ACC,,Virginia,1968,N,N
11,4,0,7,FBS Independents,,Virginia Tech,1968,N,N
10,9,0,1,Southern,,VMI,1968,N,N
10,8,0,2,ACC,,Wake Forest,1968,N,N
10,7,0,3,Pac-8,,Washington,1968,N,N
10,7,0,3,Pac-8,,Washington State,1968,N,N
9,6,0,3,Mid-American,,Western Michigan,1968,N,N
10,2,0,8,FBS Independents,,West Texas A&M,1968,N,N
10,3,0,7,FBS Independents,,West Virginia,1968,N,N
10,10,0,0,Missouri Valley,,Wichita State,1968,N,N
10,7,0,3,Southern,,William & Mary,1968,N,N
10,10,0,0,Big Ten,,Wisconsin,1968,N,N
10,3,0,7,Western Athletic,,Wyoming,1968,N,N
10,4,0,6,FBS Independents,,Xavier,1968,N,N
9,0,0,9,Ivy,,Yale,1968,N,N
10,4,0,6,FBS Independents,,Air Force,1969,N,N
11,5,0,6,SEC,,Alabama,1969,N,N
10,7,0,3,Western Athletic,,Arizona,1969,N,N
10,2,0,8,Western Athletic,,Arizona State,1969,N,N
11,2,0,9,Southwest,,Arkansas,1969,N,N
10,5,0,5,FBS Independents,,Army,1969,N,N
11,3,0,8,SEC,,Auburn,1969,N,N
10,10,0,0,Southwest,,Baylor,1969,N,N
9,4,0,5,FBS Independents,,Boston College,1969,N,N
10,4,0,6,Mid-American,,Bowling Green,1969,N,N
9,7,0,2,Ivy,,Brown,1969,N,N
9,3,0,6,FBS Independents,,Buffalo,1969,N,N
10,4,0,6,Western Athletic,,BYU,1969,N,N
10,5,0,5,Pac-8,,California,1969,N,N
10,4,0,6,PCAA,,California-Santa Barbara,1969,N,N
9,9,0,0,PCAA,,Cal State Los Angeles,1969,N,N
10,6,0,4,Missouri Valley,,Cincinnati,1969,N,N
10,6,0,4,ACC,,Clemson,1969,N,N
9,3,0,6,FBS Independents,,Colgate,1969,N,N
11,3,0,8,Big 8,,Colorado,1969,N,N
10,6,0,4,Western Athletic,,Colorado State,1969,N,N
9,8,0,1,Ivy,,Columbia,1969,N,N
9,5,0,4,Ivy,,Cornell,1969,N,N
9,1,0,8,Ivy,,Dartmouth,1969,N,N
11,4,0,7,Southern,,Davidson,1969,N,N
10,7,0,3,FBS Independents,,Dayton,1969,N,N
10,6,0,4,ACC,,Duke,1969,N,N
9,7,0,2,Southern,,East Carolina,1969,N,N
11,2,0,9,SEC,,Florida,1969,N,N
10,3,0,7,FBS Independents,,Florida State,1969,N,N
10,4,0,6,PCAA,,Fresno State,1969,N,N
10,9,0,1,Southern,,Furman,1969,N,N
11,5,0,6,SEC,,Georgia,1969,N,N
10,6,0,4,FBS Independents,,Georgia Tech,1969,N,N
9,6,0,3,Ivy,,Harvard,1969,N,N
11,2,0,9,FBS Independents,,Houston,1969,N,N
10,10,0,0,Big Ten,,Illinois,1969,N,N
10,6,0,4,Big Ten,,Indiana,1969,N,N
10,5,0,5,Big Ten,,Iowa,1969,N,N
10,7,0,3,Big 8,,Iowa State,1969,N,N
10,9,0,1,Big 8,,Kansas,1969,N,N
10,5,0,5,Big 8,,Kansas State,1969,N,N
10,5,0,5,Mid-American,,Kent State,1969,N,N
10,8,0,2,SEC,,Kentucky,1969,N,N
11,3,0,8,PCAA,,Long Beach State,1969,N,N
10,4,0,6,Missouri Valley,,Louisville,1969,N,N
10,1,0,9,SEC,,LSU,1969,N,N
10,7,0,3,Mid-American,,Marshall,1969,N,N
10,7,0,3,ACC,,Maryland,1969,N,N
10,2,0,8,Missouri Valley,,Memphis,1969,N,N
10,6,0,4,FBS Independents,,Miami,1969,N,N
10,3,0,7,Mid-American,,Miami (OH),1969,N,N
11,3,0,8,Big Ten,,Michigan,1969,N,N
10,6,0,4,Big Ten,,Michigan State,1969,N,N
10,6,0,4,Big Ten,,Minnesota,1969,N,N
10,7,0,3,SEC,,Mississippi State,1969,N,N
11,2,0,9,Big 8,,Missouri,1969,N,N
10,9,0,1,FBS Independents,,Navy,1969,N,N
10,7,0,3,ACC,,NC State,1969,N,N
11,2,0,9,Big 8,,Nebraska,1969,N,N
10,6,0,4,Western Athletic,,New Mexico,1969,N,N
10,5,0,5,FBS Independents,,New Mexico State,1969,N,N
10,5,0,5,ACC,,North Carolina,1969,N,N
10,7,0,3,FBS Independents,,Northern Illinois,1969,N,N
10,3,0,7,Missouri Valley,,North Texas,1969,N,N
10,7,0,3,Big Ten,,Northwestern,1969,N,N
11,3,0,8,FBS Independents,,Notre Dame,1969,N,N
10,4,0,6,Mid-American,,Ohio,1969,N,N
9,1,0,8,Big Ten,,Ohio State,1969,N,N
10,4,0,6,Big 8,,Oklahoma,1969,N,N
10,5,0,5,Big 8,,Oklahoma State,1969,N,N
11,3,0,8,SEC,,Ole Miss,1969,N,N
11,6,0,5,Pac-8,,Oregon,1969,N,N
10,4,0,6,Pac-8,,Oregon State,1969,N,N
10,3,0,7,PCAA,,Pacific,1969,N,N
11,0,0,11,FBS Independents,,Penn State,1969,N,N
9,5,0,4,Ivy,,Pennsylvania,1969,N,N
10,6,0,4,FBS Independents,,Pittsburgh,1969,N,N
9,3,0,6,Ivy,,Princeton,1969,N,N
10,2,0,8,Big Ten,,Purdue,1969,N,N
10,7,0,3,Southwest,,Rice,1969,N,N
10,4,0,6,Southern,,Richmond,1969,N,N
9,3,0,6,FBS Independents,,Rutgers,1969,N,N
11,0,0,11,PCAA,,San Diego State,1969,N,N
10,8,0,2,PCAA,,San Josï¿½ State,1969,N,N
10,7,0,3,Southwest,,SMU,1969,N,N
11,4,0,7,ACC,,South Carolina,1969,N,N
10,5,0,5,FBS Independents,,Southern Mississippi,1969,N,N
10,3,0,7,Pac-8,,Stanford,1969,N,N
10,5,0,5,FBS Independents,,Syracuse,1969,N,N
10,6,0,4,Southwest,,TCU,1969,N,N
11,2,0,9,SEC,,Tennessee,1969,N,N
11,0,0,11,Southwest,,Texas,1969,Y,N
10,7,0,3,Southwest,,Texas A&M,1969,N,N
10,5,0,5,Southwest,,Texas Tech,1969,N,N
10,3,0,7,Southern,,The Citadel,1969,N,N
11,0,0,11,Mid-American,,Toledo,1969,N,N
10,7,0,3,FBS Independents,,Tulane,1969,N,N
10,9,0,1,Missouri Valley,,Tulsa,1969,N,N
10,1,0,9,Pac-8,,UCLA,1969,N,N
11,0,0,11,Pac-8,,USC,1969,N,N
10,2,0,8,Western Athletic,,Utah,1969,N,N
10,7,0,3,FBS Independents,,Utah State,1969,N,N
10,6,0,4,Western Athletic,,UTEP,1969,N,N
10,6,0,4,SEC,,Vanderbilt,1969,N,N
9,3,0,6,FBS Independents,,Villanova,1969,N,N
10,7,0,3,ACC,,Virginia,1969,N,N
10,6,0,4,FBS Independents,,Virginia Tech,1969,N,N
10,10,0,0,Southern,,VMI,1969,N,N
10,7,0,3,ACC,,Wake Forest,1969,N,N
10,9,0,1,Pac-8,,Washington,1969,N,N
10,9,0,1,Pac-8,,Washington State,1969,N,N
10,6,0,4,Mid-American,,Western Michigan,1969,N,N
10,4,0,6,FBS Independents,,West Texas A&M,1969,N,N
11,1,0,10,FBS Independents,,West Virginia,1969,N,N
10,8,0,2,Missouri Valley,,Wichita State,1969,N,N
10,7,0,3,Southern,,William & Mary,1969,N,N
10,7,0,3,Big Ten,,Wisconsin,1969,N,N
10,4,0,6,Western Athletic,,Wyoming,1969,N,N
10,9,0,1,FBS Independents,,Xavier,1969,N,N
9,2,0,7,Ivy,,Yale,1969,N,N
12,3,0,9,FBS Independents,,Air Force,1970,N,N
12,6,0,6,SEC,,Alabama,1970,N,N
10,6,0,4,Western Athletic,,Arizona,1970,N,N
11,0,0,11,Western Athletic,,Arizona State,1970,N,N
11,2,0,9,Southwest,,Arkansas,1970,N,N
11,10,0,1,FBS Independents,,Army,1970,N,N
11,2,0,9,SEC,,Auburn,1970,N,N
11,9,0,2,Southwest,,Baylor,1970,N,N
10,2,0,8,FBS Independents,,Boston College,1970,N,N
9,7,0,2,Mid-American,,Bowling Green,1970,N,N
9,7,0,2,Ivy,,Brown,1970,N,N
11,9,0,2,FBS Independents,,Buffalo,1970,N,N
11,8,0,3,Western Athletic,,BYU,1970,N,N
11,5,0,6,Pac-8,,California,1970,N,N
11,9,0,2,PCAA,,California-Santa Barbara,1970,N,N
10,9,0,1,PCAA,,Cal State Los Angeles,1970,N,N
11,4,0,7,FBS Independents,,Cincinnati,1970,N,N
11,8,0,3,ACC,,Clemson,1970,N,N
11,6,0,5,FBS Independents,,Colgate,1970,N,N
11,5,0,6,Big 8,,Colorado,1970,N,N
11,7,0,4,Western Athletic,,Colorado State,1970,N,N
9,6,0,3,Ivy,,Columbia,1970,N,N
9,3,0,6,Ivy,,Cornell,1970,N,N
9,0,0,9,Ivy,,Dartmouth,1970,N,N
10,8,0,2,Southern,,Davidson,1970,N,N
10,4,0,6,FBS Independents,,Dayton,1970,N,N
11,5,0,6,ACC,,Duke,1970,N,N
11,8,0,3,Southern,,East Carolina,1970,N,N
11,4,0,7,SEC,,Florida,1970,N,N
11,4,0,7,FBS Independents,,Florida State,1970,N,N
12,4,0,8,PCAA,,Fresno State,1970,N,N
11,3,0,8,Southern,,Furman,1970,N,N
10,5,0,5,SEC,,Georgia,1970,N,N
12,3,0,9,FBS Independents,,Georgia Tech,1970,N,N
9,2,0,7,Ivy,,Harvard,1970,N,N
11,11,0,0,FBS Independents,,Holy Cross,1970,N,N
11,3,0,8,FBS Independents,,Houston,1970,N,N
10,7,0,3,Big Ten,,Illinois,1970,N,N
10,9,0,1,Big Ten,,Indiana,1970,N,N
10,6,0,4,Big Ten,,Iowa,1970,N,N
11,6,0,5,Big 8,,Iowa State,1970,N,N
11,6,0,5,Big 8,,Kansas,1970,N,N
11,5,0,6,Big 8,,Kansas State,1970,N,N
10,7,0,3,Mid-American,,Kent State,1970,N,N
11,9,0,2,SEC,,Kentucky,1970,N,N
12,3,0,9,PCAA,,Long Beach State,1970,N,N
12,3,0,9,Missouri Valley,,Louisville,1970,N,N
12,3,0,9,SEC,,LSU,1970,N,N
9,6,0,3,FBS Independents,,Marshall,1970,N,N
11,9,0,2,ACC,,Maryland,1970,N,N
10,4,0,6,Missouri Valley,,Memphis,1970,N,N
11,8,0,3,FBS Independents,,Miami,1970,N,N
10,3,0,7,Mid-American,,Miami (OH),1970,N,N
10,1,0,9,Big Ten,,Michigan,1970,N,N
10,6,0,4,Big Ten,,Michigan State,1970,N,N
10,7,0,3,Big Ten,,Minnesota,1970,N,N
11,5,0,6,SEC,,Mississippi State,1970,N,N
11,6,0,5,Big 8,,Missouri,1970,N,N
11,9,0,2,FBS Independents,,Navy,1970,N,N
11,8,0,3,ACC,,NC State,1970,N,N
12,0,0,12,Big 8,,Nebraska,1970,Y,N
10,3,0,7,Western Athletic,,New Mexico,1970,N,N
10,6,0,4,FBS Independents,,New Mexico State,1970,N,N
12,4,0,8,ACC,,North Carolina,1970,N,N
10,7,0,3,FBS Independents,,Northern Illinois,1970,N,N
11,8,0,3,Missouri Valley,,North Texas,1970,N,N
10,4,0,6,Big Ten,,Northwestern,1970,N,N
11,1,0,10,FBS Independents,,Notre Dame,1970,N,N
9,5,0,4,Mid-American,,Ohio,1970,N,N
10,1,0,9,Big Ten,,Ohio State,1970,Y,N
12,4,0,8,Big 8,,Oklahoma,1970,N,N
11,7,0,4,Big 8,,Oklahoma State,1970,N,N
11,4,0,7,SEC,,Ole Miss,1970,N,N
11,4,0,7,Pac-8,,Oregon,1970,N,N
11,5,0,6,Pac-8,,Oregon State,1970,N,N
11,6,0,5,PCAA,,Pacific,1970,N,N
10,3,0,7,FBS Independents,,Penn State,1970,N,N
9,5,0,4,Ivy,,Pennsylvania,1970,N,N
10,5,0,5,FBS Independents,,Pittsburgh,1970,N,N
9,4,0,5,Ivy,,Princeton,1970,N,N
10,6,0,4,Big Ten,,Purdue,1970,N,N
10,5,0,5,Southwest,,Rice,1970,N,N
10,6,0,4,Southern,,Richmond,1970,N,N
10,5,0,5,FBS Independents,,Rutgers,1970,N,N
11,2,0,9,PCAA,,San Diego State,1970,N,N
11,9,0,2,PCAA,,San Josï¿½ State,1970,N,N
11,6,0,5,Southwest,,SMU,1970,N,N
11,6,0,5,ACC,,South Carolina,1970,N,N
11,6,0,5,FBS Independents,,Southern Mississippi,1970,N,N
12,3,0,9,Pac-8,,Stanford,1970,N,N
10,4,0,6,FBS Independents,,Syracuse,1970,N,N
11,6,0,5,Southwest,,TCU,1970,N,N
12,1,0,11,SEC,,Tennessee,1970,N,N
11,1,0,10,Southwest,,Texas,1970,Y,N
11,9,0,2,Southwest,,Texas A&M,1970,N,N
12,4,0,8,Southwest,,Texas Tech,1970,N,N
11,6,0,5,Southern,,The Citadel,1970,N,N
12,0,0,12,Mid-American,,Toledo,1970,N,N
12,4,0,8,FBS Independents,,Tulane,1970,N,N
10,4,0,6,Missouri Valley,,Tulsa,1970,N,N
11,5,0,6,Pac-8,,UCLA,1970,N,N
11,5,0,6,Pac-8,,USC,1970,N,N
10,4,0,6,Western Athletic,,Utah,1970,N,N
10,5,0,5,FBS Independents,,Utah State,1970,N,N
10,4,0,6,Western Athletic,,UTEP,1970,N,N
11,7,0,4,SEC,,Vanderbilt,1970,N,N
11,2,0,9,FBS Independents,,Villanova,1970,N,N
11,6,0,5,ACC,,Virginia,1970,N,N
11,6,0,5,FBS Independents,,Virginia Tech,1970,N,N
11,10,0,1,Southern,,VMI,1970,N,N
11,5,0,6,ACC,,Wake Forest,1970,N,N
10,4,0,6,Pac-8,,Washington,1970,N,N
11,10,0,1,Pac-8,,Washington State,1970,N,N
10,3,0,7,Mid-American,,Western Michigan,1970,N,N
10,3,0,7,FBS Independents,,West Texas A&M,1970,N,N
11,3,0,8,FBS Independents,,West Virginia,1970,N,N
9,9,0,0,Missouri Valley,,Wichita State,1970,N,N
12,7,0,5,Southern,,William & Mary,1970,N,N
10,6,0,4,Big Ten,,Wisconsin,1970,N,N
10,9,0,1,Western Athletic,,Wyoming,1970,N,N
10,9,0,1,FBS Independents,,Xavier,1970,N,N
9,2,0,7,Ivy,,Yale,1970,N,N
10,4,0,6,FBS Independents,,Air Force,1971,N,N
12,1,0,11,SEC,,Alabama,1971,N,N
11,6,0,5,Western Athletic,,Arizona,1971,N,N
12,1,0,11,Western Athletic,,Arizona State,1971,N,N
12,3,0,9,Southwest,,Arkansas,1971,N,N
10,4,0,6,FBS Independents,,Army,1971,N,N
11,2,0,9,SEC,,Auburn,1971,N,N
10,9,0,1,Southwest,,Baylor,1971,N,N
11,2,0,9,FBS Independents,,Boston College,1971,N,N
10,4,0,6,Mid-American,,Bowling Green,1971,N,N
9,9,0,0,Ivy,,Brown,1971,N,N
11,6,0,5,Western Athletic,,BYU,1971,N,N
11,5,0,6,Pac-8,,California,1971,N,N
11,8,0,3,PCAA,,California-Santa Barbara,1971,N,N
10,8,0,2,PCAA,,Cal State Los Angeles,1971,N,N
11,9,0,2,FBS Independents,,Chattanooga,1971,N,N
11,4,0,7,FBS Independents,,Cincinnati,1971,N,N
11,6,0,5,ACC,,Clemson,1971,N,N
10,4,0,6,FBS Independents,,Colgate,1971,N,N
12,2,0,10,Big 8,,Colorado,1971,N,N
11,8,0,3,Western Athletic,,Colorado State,1971,N,N
9,3,0,6,Ivy,,Columbia,1971,N,N
9,1,0,8,Ivy,,Cornell,1971,N,N
9,1,0,8,Ivy,,Dartmouth,1971,N,N
10,9,0,1,Southern,,Davidson,1971,N,N
11,6,0,5,FBS Independents,,Dayton,1971,N,N
11,4,0,7,Missouri Valley,,Drake,1971,N,N
11,5,0,6,ACC,,Duke,1971,N,N
10,6,0,4,Southern,,East Carolina,1971,N,N
11,7,0,4,SEC,,Florida,1971,N,N
12,4,0,8,FBS Independents,,Florida State,1971,N,N
11,5,0,6,PCAA,,Fresno State,1971,N,N
11,6,0,5,Southern,,Furman,1971,N,N
12,1,0,11,SEC,,Georgia,1971,N,N
12,6,0,6,FBS Independents,,Georgia Tech,1971,N,N
9,4,0,5,Ivy,,Harvard,1971,N,N
11,4,0,7,FBS Independents,,Hawai'i,1971,N,N
10,6,0,4,FBS Independents,,Holy Cross,1971,N,N
12,3,0,9,FBS Independents,,Houston,1971,N,N
11,6,0,5,Big Ten,,Illinois,1971,N,N
11,8,0,3,Big Ten,,Indiana,1971,N,N
11,10,0,1,Big Ten,,Iowa,1971,N,N
12,4,0,8,Big 8,,Iowa State,1971,N,N
11,7,0,4,Big 8,,Kansas,1971,N,N
11,6,0,5,Big 8,,Kansas State,1971,N,N
11,8,0,3,Mid-American,,Kent State,1971,N,N
11,8,0,3,SEC,,Kentucky,1971,N,N
12,4,0,8,PCAA,,Long Beach State,1971,N,N
10,3,0,7,Missouri Valley,,Louisville,1971,N,N
12,3,0,9,SEC,,LSU,1971,N,N
10,8,0,2,FBS Independents,,Marshall,1971,N,N
11,9,0,2,ACC,,Maryland,1971,N,N
11,6,0,5,Missouri Valley,,Memphis,1971,N,N
11,7,0,4,FBS Independents,,Miami,1971,N,N
10,3,0,7,Mid-American,,Miami (OH),1971,N,N
12,1,0,11,Big Ten,,Michigan,1971,N,N
11,5,0,6,Big Ten,,Michigan State,1971,N,N
11,7,0,4,Big Ten,,Minnesota,1971,N,N
11,9,0,2,SEC,,Mississippi State,1971,N,N
11,10,0,1,Big 8,,Missouri,1971,N,N
11,8,0,3,FBS Independents,,Navy,1971,N,N
11,8,0,3,ACC,,NC State,1971,N,N
13,0,0,13,Big 8,,Nebraska,1971,Y,N
11,4,0,7,Western Athletic,,New Mexico,1971,N,N
11,5,0,6,FBS Independents,,New Mexico State,1971,N,N
12,3,0,9,ACC,,North Carolina,1971,N,N
11,6,0,5,FBS Independents,,Northern Illinois,1971,N,N
11,8,0,3,Missouri Valley,,North Texas,1971,N,N
11,4,0,7,Big Ten,,Northwestern,1971,N,N
10,2,0,8,FBS Independents,,Notre Dame,1971,N,N
10,5,0,5,Mid-American,,Ohio,1971,N,N
10,4,0,6,Big Ten,,Ohio State,1971,N,N
12,1,0,11,Big 8,,Oklahoma,1971,N,N
11,6,0,5,Big 8,,Oklahoma State,1971,N,N
12,2,0,10,SEC,,Ole Miss,1971,N,N
11,6,0,5,Pac-8,,Oregon,1971,N,N
11,6,0,5,Pac-8,,Oregon State,1971,N,N
11,8,0,3,PCAA,,Pacific,1971,N,N
12,1,0,11,FBS Independents,,Penn State,1971,N,N
9,7,0,2,Ivy,,Pennsylvania,1971,N,N
11,8,0,3,FBS Independents,,Pittsburgh,1971,N,N
9,5,0,4,Ivy,,Princeton,1971,N,N
10,7,0,3,Big Ten,,Purdue,1971,N,N
11,8,0,3,Southwest,,Rice,1971,N,N
11,6,0,5,Southern,,Richmond,1971,N,N
11,7,0,4,FBS Independents,,Rutgers,1971,N,N
11,5,0,6,PCAA,,San Diego State,1971,N,N
12,7,0,5,PCAA,,San Josï¿½ State,1971,N,N
11,7,0,4,Southwest,,SMU,1971,N,N
11,5,0,6,FBS Independents,,South Carolina,1971,N,N
11,5,0,6,FBS Independents,,Southern Mississippi,1971,N,N
12,3,0,9,Pac-8,,Stanford,1971,N,N
11,6,0,5,FBS Independents,,Syracuse,1971,N,N
11,5,0,6,FBS Independents,,Tampa,1971,N,N
11,5,0,6,Southwest,,TCU,1971,N,N
9,3,0,6,FBS Independents,,Temple,1971,N,N
12,2,0,10,SEC,,Tennessee,1971,N,N
11,3,0,8,Southwest,,Texas,1971,N,N
11,6,0,5,Southwest,,Texas A&M,1971,N,N
11,9,0,2,FBS Independents,,Texas-Arlington,1971,N,N
11,7,0,4,Southwest,,Texas Tech,1971,N,N
11,3,0,8,Southern,,The Citadel,1971,N,N
12,0,0,12,Mid-American,,Toledo,1971,N,N
11,8,0,3,FBS Independents,,Tulane,1971,N,N
11,7,0,4,Missouri Valley,,Tulsa,1971,N,N
10,7,0,3,Pac-8,,UCLA,1971,N,N
11,5,0,6,Pac-8,,USC,1971,N,N
11,8,0,3,Western Athletic,,Utah,1971,N,N
11,3,0,8,FBS Independents,,Utah State,1971,N,N
11,6,0,5,Western Athletic,,UTEP,1971,N,N
11,7,0,4,SEC,,Vanderbilt,1971,N,N
11,4,0,7,FBS Independents,,Villanova,1971,N,N
11,8,0,3,ACC,,Virginia,1971,N,N
11,7,0,4,FBS Independents,,Virginia Tech,1971,N,N
11,10,0,1,Southern,,VMI,1971,N,N
11,5,0,6,ACC,,Wake Forest,1971,N,N
11,3,0,8,Pac-8,,Washington,1971,N,N
11,7,0,4,Pac-8,,Washington State,1971,N,N
10,3,0,7,Mid-American,,Western Michigan,1971,N,N
11,9,0,2,Missouri Valley,,West Texas A&M,1971,N,N
11,4,0,7,FBS Independents,,West Virginia,1971,N,N
11,8,0,3,Missouri Valley,,Wichita State,1971,N,N
11,6,0,5,Southern,,William & Mary,1971,N,N
11,6,0,5,Big Ten,,Wisconsin,1971,N,N
11,6,0,5,Western Athletic,,Wyoming,1971,N,N
10,9,0,1,FBS Independents,,Xavier,1971,N,N
9,5,0,4,Ivy,,Yale,1971,N,N
10,4,0,6,FBS Independents,,Air Force,1972,N,N
12,2,0,10,SEC,,Alabama,1972,N,N
11,6,0,5,Southern,,Appalachian State,1972,N,N
11,7,0,4,Western Athletic,,Arizona,1972,N,N
12,2,0,10,Western Athletic,,Arizona State,1972,N,N
11,5,0,6,Southwest,,Arkansas,1972,N,N
10,4,0,6,FBS Independents,,Army,1972,N,N
11,1,0,10,SEC,,Auburn,1972,N,N
11,6,0,5,Southwest,,Baylor,1972,N,N
11,7,0,4,FBS Independents,,Boston College,1972,N,N
10,3,0,7,Mid-American,,Bowling Green,1972,N,N
9,8,0,1,Ivy,,Brown,1972,N,N
11,4,0,7,Western Athletic,,BYU,1972,N,N
11,8,0,3,Pac-8,,California,1972,N,N
11,9,0,2,FBS Independents,,Chattanooga,1972,N,N
11,9,0,2,FBS Independents,,Cincinnati,1972,N,N
11,7,0,4,ACC,,Clemson,1972,N,N
10,5,0,5,FBS Independents,,Colgate,1972,N,N
12,4,0,8,Big 8,,Colorado,1972,N,N
11,10,0,1,Western Athletic,,Colorado State,1972,N,N
9,5,0,4,Ivy,,Columbia,1972,N,N
9,3,0,6,Ivy,,Cornell,1972,N,N
9,1,0,8,Ivy,,Dartmouth,1972,N,N
11,7,0,4,Southern,,Davidson,1972,N,N
11,6,0,5,FBS Independents,,Dayton,1972,N,N
12,5,0,7,Missouri Valley,,Drake,1972,N,N
11,6,0,5,ACC,,Duke,1972,N,N
11,2,0,9,Southern,,East Carolina,1972,N,N
11,6,0,5,SEC,,Florida,1972,N,N
11,4,0,7,FBS Independents,,Florida State,1972,N,N
11,5,0,6,PCAA,,Fresno State,1972,N,N
11,9,0,2,Southern,,Furman,1972,N,N
11,4,0,7,SEC,,Georgia,1972,N,N
12,5,0,7,FBS Independents,,Georgia Tech,1972,N,N
9,5,0,4,Ivy,,Harvard,1972,N,N
10,4,0,6,FBS Independents,,Holy Cross,1972,N,N
11,4,0,7,FBS Independents,,Houston,1972,N,N
11,8,0,3,Big Ten,,Illinois,1972,N,N
11,6,0,5,Big Ten,,Indiana,1972,N,N
11,8,0,3,Big Ten,,Iowa,1972,N,N
12,7,0,5,Big 8,,Iowa State,1972,N,N
11,7,0,4,Big 8,,Kansas,1972,N,N
11,8,0,3,Big 8,,Kansas State,1972,N,N
12,5,0,7,Mid-American,,Kent State,1972,N,N
11,8,0,3,SEC,,Kentucky,1972,N,N
11,6,0,5,PCAA,,Long Beach State,1972,N,N
10,1,0,9,Missouri Valley,,Louisville,1972,N,N
12,2,0,10,SEC,,LSU,1972,N,N
10,8,0,2,FBS Independents,,Marshall,1972,N,N
11,5,0,6,ACC,,Maryland,1972,N,N
11,5,0,6,Missouri Valley,,Memphis,1972,N,N
11,6,0,5,FBS Independents,,Miami,1972,N,N
10,3,0,7,Mid-American,,Miami (OH),1972,N,N
11,1,0,10,Big Ten,,Michigan,1972,N,N
11,5,0,6,Big Ten,,Michigan State,1972,N,N
11,7,0,4,Big Ten,,Minnesota,1972,N,N
11,7,0,4,SEC,,Mississippi State,1972,N,N
12,6,0,6,Big 8,,Missouri,1972,N,N
11,7,0,4,FBS Independents,,Navy,1972,N,N
12,4,0,8,ACC,,NC State,1972,N,N
12,2,0,10,Big 8,,Nebraska,1972,N,N
11,8,0,3,Western Athletic,,New Mexico,1972,N,N
11,9,0,2,Missouri Valley,,New Mexico State,1972,N,N
12,1,0,11,ACC,,North Carolina,1972,N,N
11,4,0,7,FBS Independents,,Northern Illinois,1972,N,N
11,10,0,1,Missouri Valley,,North Texas,1972,N,N
11,9,0,2,Big Ten,,Northwestern,1972,N,N
11,3,0,8,FBS Independents,,Notre Dame,1972,N,N
11,8,0,3,Mid-American,,Ohio,1972,N,N
11,2,0,9,Big Ten,,Ohio State,1972,N,N
12,1,0,11,Big 8,,Oklahoma,1972,N,N
11,5,0,6,Big 8,,Oklahoma State,1972,N,N
10,5,0,5,SEC,,Ole Miss,1972,N,N
11,7,0,4,Pac-8,,Oregon,1972,N,N
11,9,0,2,Pac-8,,Oregon State,1972,N,N
11,3,0,8,PCAA,,Pacific,1972,N,N
12,2,0,10,FBS Independents,,Penn State,1972,N,N
9,3,0,6,Ivy,,Pennsylvania,1972,N,N
11,10,0,1,FBS Independents,,Pittsburgh,1972,N,N
9,6,0,3,Ivy,,Princeton,1972,N,N
11,5,0,6,Big Ten,,Purdue,1972,N,N
11,5,0,6,Southwest,,Rice,1972,N,N
10,4,0,6,Southern,,Richmond,1972,N,N
11,4,0,7,FBS Independents,,Rutgers,1972,N,N
11,1,0,10,PCAA,,San Diego State,1972,N,N
11,7,0,4,PCAA,,San Josï¿½ State,1972,N,N
11,4,0,7,Southwest,,SMU,1972,N,N
11,7,0,4,FBS Independents,,South Carolina,1972,N,N
10,9,0,1,FBS Independents,,Southern Illinois,1972,N,N
11,8,0,3,FBS Independents,,Southern Mississippi,1972,N,N
11,5,0,6,Pac-8,,Stanford,1972,N,N
11,6,0,5,FBS Independents,,Syracuse,1972,N,N
12,2,0,10,FBS Independents,,Tampa,1972,N,N
11,6,0,5,Southwest,,TCU,1972,N,N
9,4,0,5,FBS Independents,,Temple,1972,N,N
12,2,0,10,SEC,,Tennessee,1972,N,N
11,1,0,10,Southwest,,Texas,1972,N,N
11,8,0,3,Southwest,,Texas A&M,1972,N,N
11,6,0,5,FBS Independents,,Texas-Arlington,1972,N,N
12,4,0,8,Southwest,,Texas Tech,1972,N,N
11,6,0,5,Southern,,The Citadel,1972,N,N
11,5,0,6,Mid-American,,Toledo,1972,N,N
11,5,0,6,FBS Independents,,Tulane,1972,N,N
11,7,0,4,Missouri Valley,,Tulsa,1972,N,N
11,3,0,8,Pac-8,,UCLA,1972,N,N
12,0,0,12,Pac-8,,USC,1972,Y,N
11,5,0,6,Western Athletic,,Utah,1972,N,N
11,3,0,8,FBS Independents,,Utah State,1972,N,N
10,8,0,2,Western Athletic,,UTEP,1972,N,N
11,8,0,3,SEC,,Vanderbilt,1972,N,N
11,9,0,2,FBS Independents,,Villanova,1972,N,N
11,7,0,4,ACC,,Virginia,1972,N,N
11,5,0,6,FBS Independents,,Virginia Tech,1972,N,N
11,9,0,2,Southern,,VMI,1972,N,N
11,9,0,2,ACC,,Wake Forest,1972,N,N
11,3,0,8,Pac-8,,Washington,1972,N,N
11,4,0,7,Pac-8,,Washington State,1972,N,N
11,4,0,7,Mid-American,,Western Michigan,1972,N,N
10,5,0,5,Missouri Valley,,West Texas A&M,1972,N,N
12,4,0,8,FBS Independents,,West Virginia,1972,N,N
11,5,0,6,Missouri Valley,,Wichita State,1972,N,N
11,6,0,5,Southern,,William & Mary,1972,N,N
11,7,0,4,Big Ten,,Wisconsin,1972,N,N
11,7,0,4,Western Athletic,,Wyoming,1972,N,N
10,8,0,2,FBS Independents,,Xavier,1972,N,N
9,2,0,7,Ivy,,Yale,1972,N,N
10,4,0,6,FBS Independents,,Air Force,1973,N,N
12,1,0,11,SEC,,Alabama,1973,Y,N
11,7,0,4,Southern,,Appalachian State,1973,N,N
11,3,0,8,Western Athletic,,Arizona,1973,N,N
12,1,0,11,Western Athletic,,Arizona State,1973,N,N
11,5,0,6,Southwest,,Arkansas,1973,N,N
10,10,0,0,FBS Independents,,Army,1973,N,N
12,6,0,6,SEC,,Auburn,1973,N,N
11,9,0,2,Southwest,,Baylor,1973,N,N
11,4,0,7,FBS Independents,,Boston College,1973,N,N
10,3,0,7,Mid-American,,Bowling Green,1973,N,N
8,4,0,4,Ivy,,Brown,1973,N,N
11,6,0,5,Western Athletic,,BYU,1973,N,N
11,7,0,4,Pac-8,,California,1973,N,N
11,7,0,4,FBS Independents,,Chattanooga,1973,N,N
11,7,0,4,FBS Independents,,Cincinnati,1973,N,N
11,6,0,5,ACC,,Clemson,1973,N,N
10,5,0,5,FBS Independents,,Colgate,1973,N,N
11,6,0,5,Big 8,,Colorado,1973,N,N
11,6,0,5,Western Athletic,,Colorado State,1973,N,N
9,8,0,1,Ivy,,Columbia,1973,N,N
9,6,0,3,Ivy,,Cornell,1973,N,N
9,3,0,6,Ivy,,Dartmouth,1973,N,N
10,8,0,2,Southern,,Davidson,1973,N,N
11,5,0,6,FBS Independents,,Dayton,1973,N,N
11,9,0,2,Missouri Valley,,Drake,1973,N,N
11,8,0,3,ACC,,Duke,1973,N,N
11,2,0,9,Southern,,East Carolina,1973,N,N
12,5,0,7,SEC,,Florida,1973,N,N
11,11,0,0,FBS Independents,,Florida State,1973,N,N
11,9,0,2,PCAA,,Fresno State,1973,N,N
11,4,0,7,Southern,,Furman,1973,N,N
12,5,0,7,SEC,,Georgia,1973,N,N
11,6,0,5,FBS Independents,,Georgia Tech,1973,N,N
9,2,0,7,Ivy,,Harvard,1973,N,N
11,6,0,5,FBS Independents,,Holy Cross,1973,N,N
12,1,0,11,FBS Independents,,Houston,1973,N,N
11,6,0,5,Big Ten,,Illinois,1973,N,N
11,9,0,2,Big Ten,,Indiana,1973,N,N
11,11,0,0,Big Ten,,Iowa,1973,N,N
11,7,0,4,Big 8,,Iowa State,1973,N,N
12,5,0,7,Big 8,,Kansas,1973,N,N
11,6,0,5,Big 8,,Kansas State,1973,N,N
11,2,0,9,Mid-American,,Kent State,1973,N,N
11,6,0,5,SEC,,Kentucky,1973,N,N
10,5,0,5,FBS Independents,,Lamar,1973,N,N
11,9,0,2,PCAA,,Long Beach State,1973,N,N
10,10,0,0,FBS Independents,,Louisiana,1973,N,N
11,6,0,5,Missouri Valley,,Louisville,1973,N,N
12,3,0,9,SEC,,LSU,1973,N,N
11,7,0,4,FBS Independents,,Marshall,1973,N,N
12,4,0,8,ACC,,Maryland,1973,N,N
11,3,0,8,FBS Independents,,Memphis,1973,N,N
11,6,0,5,FBS Independents,,Miami,1973,N,N
11,0,0,11,Mid-American,,Miami (OH),1973,N,N
11,1,0,10,Big Ten,,Michigan,1973,N,N
11,6,0,5,Big Ten,,Michigan State,1973,N,N
11,4,0,7,Big Ten,,Minnesota,1973,N,N
11,7,0,4,SEC,,Mississippi State,1973,N,N
12,4,0,8,Big 8,,Missouri,1973,N,N
11,7,0,4,FBS Independents,,Navy,1973,N,N
12,3,0,9,ACC,,NC State,1973,N,N
12,2,0,10,Big 8,,Nebraska,1973,N,N
11,7,0,4,Western Athletic,,New Mexico,1973,N,N
11,6,0,5,Missouri Valley,,New Mexico State,1973,N,N
11,7,0,4,ACC,,North Carolina,1973,N,N
11,5,0,6,FBS Independents,,Northern Illinois,1973,N,N
11,6,0,5,Missouri Valley,,North Texas,1973,N,N
11,7,0,4,Big Ten,,Northwestern,1973,N,N
11,0,0,11,FBS Independents,,Notre Dame,1973,Y,N
10,5,0,5,Mid-American,,Ohio,1973,N,N
11,0,0,11,Big Ten,,Ohio State,1973,N,N
11,0,0,11,Big 8,,Oklahoma,1973,N,N
11,5,0,6,Big 8,,Oklahoma State,1973,N,N
11,5,0,6,SEC,,Ole Miss,1973,N,N
11,9,0,2,Pac-8,,Oregon,1973,N,N
11,9,0,2,Pac-8,,Oregon State,1973,N,N
10,2,0,8,PCAA,,Pacific,1973,N,N
12,0,0,12,FBS Independents,,Penn State,1973,N,N
9,3,0,6,Ivy,,Pennsylvania,1973,N,N
12,5,0,7,FBS Independents,,Pittsburgh,1973,N,N
9,8,0,1,Ivy,,Princeton,1973,N,N
11,6,0,5,Big Ten,,Purdue,1973,N,N
11,6,0,5,Southwest,,Rice,1973,N,N
10,2,0,8,Southern,,Richmond,1973,N,N
11,5,0,6,FBS Independents,,Rutgers,1973,N,N
11,1,0,10,PCAA,,San Diego State,1973,N,N
11,6,0,5,PCAA,,San Josï¿½ State,1973,N,N
11,5,0,6,Southwest,,SMU,1973,N,N
11,4,0,7,FBS Independents,,South Carolina,1973,N,N
11,7,0,4,FBS Independents,,Southern Illinois,1973,N,N
11,4,0,7,FBS Independents,,Southern Mississippi,1973,N,N
11,4,0,7,Pac-8,,Stanford,1973,N,N
11,9,0,2,FBS Independents,,Syracuse,1973,N,N
11,3,0,8,FBS Independents,,Tampa,1973,N,N
11,8,0,3,Southwest,,TCU,1973,N,N
10,1,0,9,FBS Independents,,Temple,1973,N,N
12,4,0,8,SEC,,Tennessee,1973,N,N
11,3,0,8,Southwest,,Texas,1973,N,N
11,6,0,5,Southwest,,Texas A&M,1973,N,N
10,6,0,4,FBS Independents,,Texas-Arlington,1973,N,N
12,1,0,11,Southwest,,Texas Tech,1973,N,N
11,8,0,3,Southern,,The Citadel,1973,N,N
11,8,0,3,Mid-American,,Toledo,1973,N,N
12,3,0,9,FBS Independents,,Tulane,1973,N,N
11,5,0,6,Missouri Valley,,Tulsa,1973,N,N
11,2,0,9,Pac-8,,UCLA,1973,N,N
12,3,0,9,Pac-8,,USC,1973,N,N
12,5,0,7,Western Athletic,,Utah,1973,N,N
11,4,0,7,FBS Independents,,Utah State,1973,N,N
11,11,0,0,Western Athletic,,UTEP,1973,N,N
11,6,0,5,SEC,,Vanderbilt,1973,N,N
11,8,0,3,FBS Independents,,Villanova,1973,N,N
11,7,0,4,ACC,,Virginia,1973,N,N
11,9,0,2,FBS Independents,,Virginia Tech,1973,N,N
11,8,0,3,Southern,,VMI,1973,N,N
11,10,0,1,ACC,,Wake Forest,1973,N,N
11,9,0,2,Pac-8,,Washington,1973,N,N
11,6,0,5,Pac-8,,Washington State,1973,N,N
11,5,0,6,Mid-American,,Western Michigan,1973,N,N
11,9,0,2,Missouri Valley,,West Texas A&M,1973,N,N
11,5,0,6,FBS Independents,,West Virginia,1973,N,N
11,7,0,4,Missouri Valley,,Wichita State,1973,N,N
11,5,0,6,Southern,,William & Mary,1973,N,N
11,7,0,4,Big Ten,,Wisconsin,1973,N,N
11,7,0,4,Western Athletic,,Wyoming,1973,N,N
11,6,0,5,FBS Independents,,Xavier,1973,N,N
9,3,0,6,Ivy,,Yale,1973,N,N
11,9,0,2,FBS Independents,,Air Force,1974,N,N
12,1,0,11,SEC,,Alabama,1974,N,N
11,5,0,6,Southern,,Appalachian State,1974,N,N
11,2,0,9,Western Athletic,,Arizona,1974,N,N
12,5,0,7,Western Athletic,,Arizona State,1974,N,N
11,5,0,6,Southwest,,Arkansas,1974,N,N
10,3,0,7,FBS Independents,,Arkansas State,1974,N,N
11,8,0,3,FBS Independents,,Army,1974,N,N
12,2,0,10,SEC,,Auburn,1974,N,N
12,4,0,8,Southwest,,Baylor,1974,N,N
11,3,0,8,FBS Independents,,Boston College,1974,N,N
11,4,0,7,Mid-American,,Bowling Green,1974,N,N
9,4,0,5,Ivy,,Brown,1974,N,N
12,4,0,8,Western Athletic,,BYU,1974,N,N
11,3,0,8,Pac-8,,California,1974,N,N
11,7,0,4,FBS Independents,,Chattanooga,1974,N,N
11,4,0,7,FBS Independents,,Cincinnati,1974,N,N
11,4,0,7,ACC,,Clemson,1974,N,N
10,6,0,4,FBS Independents,,Colgate,1974,N,N
11,6,0,5,Big 8,,Colorado,1974,N,N
11,7,0,4,Western Athletic,,Colorado State,1974,N,N
9,8,0,1,Ivy,,Columbia,1974,N,N
9,6,0,3,Ivy,,Cornell,1974,N,N
9,6,0,3,Ivy,,Dartmouth,1974,N,N
11,8,0,3,FBS Independents,,Dayton,1974,N,N
11,8,0,3,Missouri Valley,,Drake,1974,N,N
11,5,0,6,ACC,,Duke,1974,N,N
11,4,0,7,Southern,,East Carolina,1974,N,N
12,4,0,8,SEC,,Florida,1974,N,N
11,10,0,1,FBS Independents,,Florida State,1974,N,N
12,7,0,5,PCAA,,Fresno State,1974,N,N
11,6,0,5,Southern,,Furman,1974,N,N
12,6,0,6,SEC,,Georgia,1974,N,N
11,5,0,6,FBS Independents,,Georgia Tech,1974,N,N
9,2,0,7,Ivy,,Harvard,1974,N,N
11,5,0,6,FBS Independents,,Hawai'i,1974,N,N
11,5,0,6,FBS Independents,,Holy Cross,1974,N,N
12,4,0,8,FBS Independents,,Houston,1974,N,N
11,5,0,6,Big Ten,,Illinois,1974,N,N
11,10,0,1,Big Ten,,Indiana,1974,N,N
11,8,0,3,Big Ten,,Iowa,1974,N,N
11,7,0,4,Big 8,,Iowa State,1974,N,N
11,7,0,4,Big 8,,Kansas,1974,N,N
11,7,0,4,Big 8,,Kansas State,1974,N,N
11,4,0,7,Mid-American,,Kent State,1974,N,N
11,5,0,6,SEC,,Kentucky,1974,N,N
10,2,0,8,FBS Independents,,Lamar,1974,N,N
11,5,0,6,PCAA,,Long Beach State,1974,N,N
11,9,0,2,FBS Independents,,Louisiana,1974,N,N
11,7,0,4,Missouri Valley,,Louisville,1974,N,N
11,5,0,6,SEC,,LSU,1974,N,N
11,10,0,1,FBS Independents,,Marshall,1974,N,N
12,4,0,8,ACC,,Maryland,1974,N,N
11,4,0,7,FBS Independents,,Memphis,1974,N,N
11,5,0,6,FBS Independents,,Miami,1974,N,N
11,0,0,11,Mid-American,,Miami (OH),1974,N,N
11,1,0,10,Big Ten,,Michigan,1974,N,N
11,3,0,8,Big Ten,,Michigan State,1974,N,N
11,7,0,4,Big Ten,,Minnesota,1974,N,N
12,3,0,9,SEC,,Mississippi State,1974,N,N
11,4,0,7,Big 8,,Missouri,1974,N,N
11,7,0,4,FBS Independents,,Navy,1974,N,N
12,2,0,10,ACC,,NC State,1974,N,N
12,3,0,9,Big 8,,Nebraska,1974,N,N
11,7,0,4,Western Athletic,,New Mexico,1974,N,N
11,6,0,5,Missouri Valley,,New Mexico State,1974,N,N
12,5,0,7,ACC,,North Carolina,1974,N,N
11,7,0,4,FBS Independents,,Northern Illinois,1974,N,N
11,7,0,4,Missouri Valley,,North Texas,1974,N,N
11,8,0,3,Big Ten,,Northwestern,1974,N,N
12,2,0,10,FBS Independents,,Notre Dame,1974,N,N
11,5,0,6,Mid-American,,Ohio,1974,N,N
12,2,0,10,Big Ten,,Ohio State,1974,N,N
11,0,0,11,Big 8,,Oklahoma,1974,Y,N
12,5,0,7,Big 8,,Oklahoma State,1974,N,N
11,8,0,3,SEC,,Ole Miss,1974,N,N
11,9,0,2,Pac-8,,Oregon,1974,N,N
11,8,0,3,Pac-8,,Oregon State,1974,N,N
11,5,0,6,PCAA,,Pacific,1974,N,N
12,2,0,10,FBS Independents,,Penn State,1974,N,N
9,2,0,7,Ivy,,Pennsylvania,1974,N,N
11,4,0,7,FBS Independents,,Pittsburgh,1974,N,N
9,5,0,4,Ivy,,Princeton,1974,N,N
11,7,0,4,Big Ten,,Purdue,1974,N,N
11,9,0,2,Southwest,,Rice,1974,N,N
10,5,0,5,Southern,,Richmond,1974,N,N
11,3,0,8,FBS Independents,,Rutgers,1974,N,N
11,3,0,8,PCAA,,San Diego State,1974,N,N
12,3,0,9,PCAA,,San Josï¿½ State,1974,N,N
11,4,0,7,Southwest,,SMU,1974,N,N
11,7,0,4,FBS Independents,,South Carolina,1974,N,N
11,9,0,2,FBS Independents,,Southern Illinois,1974,N,N
11,5,0,6,FBS Independents,,Southern Mississippi,1974,N,N
11,5,0,6,Pac-8,,Stanford,1974,N,N
11,9,0,2,FBS Independents,,Syracuse,1974,N,N
11,5,0,6,FBS Independents,,Tampa,1974,N,N
11,10,0,1,Southwest,,TCU,1974,N,N
10,2,0,8,FBS Independents,,Temple,1974,N,N
12,4,0,8,SEC,,Tennessee,1974,N,N
12,4,0,8,Southwest,,Texas,1974,N,N
11,3,0,8,Southwest,,Texas A&M,1974,N,N
11,10,0,1,FBS Independents,,Texas-Arlington,1974,N,N
12,5,0,7,Southwest,,Texas Tech,1974,N,N
11,7,0,4,Southern,,The Citadel,1974,N,N
11,5,0,6,Mid-American,,Toledo,1974,N,N
11,6,0,5,FBS Independents,,Tulane,1974,N,N
11,3,0,8,Missouri Valley,,Tulsa,1974,N,N
11,4,0,7,Pac-8,,UCLA,1974,N,N
12,2,0,10,Pac-8,,USC,1974,Y,N
11,10,0,1,Western Athletic,,Utah,1974,N,N
11,3,0,8,FBS Independents,,Utah State,1974,N,N
11,7,0,4,Western Athletic,,UTEP,1974,N,N
12,4,0,8,SEC,,Vanderbilt,1974,N,N
11,8,0,3,FBS Independents,,Villanova,1974,N,N
11,7,0,4,ACC,,Virginia,1974,N,N
11,7,0,4,FBS Independents,,Virginia Tech,1974,N,N
11,4,0,7,Southern,,VMI,1974,N,N
11,10,0,1,ACC,,Wake Forest,1974,N,N
11,6,0,5,Pac-8,,Washington,1974,N,N
11,9,0,2,Pac-8,,Washington State,1974,N,N
11,8,0,3,Mid-American,,Western Michigan,1974,N,N
11,5,0,6,Missouri Valley,,West Texas A&M,1974,N,N
11,7,0,4,FBS Independents,,West Virginia,1974,N,N
11,10,0,1,Missouri Valley,,Wichita State,1974,N,N
11,7,0,4,Southern,,William & Mary,1974,N,N
11,4,0,7,Big Ten,,Wisconsin,1974,N,N
11,9,0,2,Western Athletic,,Wyoming,1974,N,N
9,1,0,8,Ivy,,Yale,1974,N,N
11,9,0,2,FBS Independents,,Air Force,1975,N,N
11,4,0,7,FBS Independents,,Akron,1975,N,N
12,1,0,11,SEC,,Alabama,1975,N,N
11,3,0,8,Southern,,Appalachian State,1975,N,N
11,2,0,9,Western Athletic,,Arizona,1975,N,N
12,0,0,12,Western Athletic,,Arizona State,1975,N,N
12,2,0,10,Southwest,,Arkansas,1975,N,N
11,0,0,11,Southland,,Arkansas State,1975,N,N
11,9,0,2,FBS Independents,,Army,1975,N,N
11,7,0,4,SEC,,Auburn,1975,N,N
11,2,0,9,Mid-American,,Ball State,1975,N,N
11,7,0,4,Southwest,,Baylor,1975,N,N
11,4,0,7,FBS Independents,,Boston College,1975,N,N
11,3,0,8,Mid-American,,Bowling Green,1975,N,N
9,2,0,7,Ivy,,Brown,1975,N,N
11,5,0,6,Western Athletic,,BYU,1975,N,N
11,3,0,8,Pac-8,,California,1975,N,N
11,9,0,2,PCAA,,Cal State Fullerton,1975,N,N
11,3,0,8,Mid-American,,Central Michigan,1975,N,N
11,6,0,5,FBS Independents,,Chattanooga,1975,N,N
11,5,0,6,FBS Independents,,Cincinnati,1975,N,N
11,9,0,2,ACC,,Clemson,1975,N,N
10,4,0,6,FBS Independents,,Colgate,1975,N,N
12,3,0,9,Big 8,,Colorado,1975,N,N
11,5,0,6,Western Athletic,,Colorado State,1975,N,N
9,7,0,2,Ivy,,Columbia,1975,N,N
9,8,0,1,Ivy,,Cornell,1975,N,N
9,4,0,5,Ivy,,Dartmouth,1975,N,N
11,6,0,5,FBS Independents,,Dayton,1975,N,N
11,8,0,3,Missouri Valley,,Drake,1975,N,N
11,7,0,4,ACC,,Duke,1975,N,N
11,3,0,8,Southern,,East Carolina,1975,N,N
10,6,0,4,FBS Independents,,Eastern Michigan,1975,N,N
12,3,0,9,SEC,,Florida,1975,N,N
11,8,0,3,FBS Independents,,Florida State,1975,N,N
11,8,0,3,PCAA,,Fresno State,1975,N,N
11,5,0,6,Southern,,Furman,1975,N,N
12,3,0,9,SEC,,Georgia,1975,N,N
11,4,0,7,FBS Independents,,Georgia Tech,1975,N,N
9,2,0,7,Ivy,,Harvard,1975,N,N
11,5,0,6,FBS Independents,,Hawai'i,1975,N,N
11,10,0,1,FBS Independents,,Holy Cross,1975,N,N
10,8,0,2,FBS Independents,,Houston,1975,N,N
11,6,0,5,Big Ten,,Illinois,1975,N,N
10,8,0,2,FBS Independents,,Illinois State,1975,N,N
11,8,0,3,Big Ten,,Indiana,1975,N,N
10,5,0,5,FBS Independents,,Indiana State,1975,N,N
11,8,0,3,Big Ten,,Iowa,1975,N,N
11,7,0,4,Big 8,,Iowa State,1975,N,N
12,5,0,7,Big 8,,Kansas,1975,N,N
11,8,0,3,Big 8,,Kansas State,1975,N,N
11,7,0,4,Mid-American,,Kent State,1975,N,N
11,9,0,2,SEC,,Kentucky,1975,N,N
11,10,0,1,Southland,,Lamar,1975,N,N
11,2,0,9,PCAA,,Long Beach State,1975,N,N
11,5,0,6,Southland,,Louisiana,1975,N,N
11,7,0,4,FBS Independents,,Louisiana Monroe,1975,N,N
10,2,0,8,Southland,,Louisiana Tech,1975,N,N
11,10,0,1,FBS Independents,,Louisville,1975,N,N
11,7,0,4,SEC,,LSU,1975,N,N
11,9,0,2,FBS Independents,,Marshall,1975,N,N
12,2,0,10,ACC,,Maryland,1975,N,N
11,4,0,7,Southland,,McNeese,1975,N,N
11,4,0,7,FBS Independents,,Memphis,1975,N,N
10,8,0,2,FBS Independents,,Miami,1975,N,N
12,1,0,11,Mid-American,,Miami (OH),1975,N,N
12,4,0,8,Big Ten,,Michigan,1975,N,N
11,4,0,7,Big Ten,,Michigan State,1975,N,N
11,5,0,6,Big Ten,,Minnesota,1975,N,N
11,4,0,7,SEC,,Mississippi State,1975,N,N
11,5,0,6,Big 8,,Missouri,1975,N,N
11,4,0,7,FBS Independents,,Navy,1975,N,N
12,4,0,8,ACC,,NC State,1975,N,N
12,2,0,10,Big 8,,Nebraska,1975,N,N
11,5,0,6,Western Athletic,,New Mexico,1975,N,N
11,6,0,5,Missouri Valley,,New Mexico State,1975,N,N
11,7,0,4,ACC,,North Carolina,1975,N,N
11,8,0,3,Mid-American,,Northern Illinois,1975,N,N
11,4,0,7,FBS Independents,,North Texas,1975,N,N
11,8,0,3,Big Ten,,Northwestern,1975,N,N
11,3,0,8,FBS Independents,,Notre Dame,1975,N,N
11,5,0,6,Mid-American,,Ohio,1975,N,N
12,1,0,11,Big Ten,,Ohio State,1975,N,N
12,1,0,11,Big 8,,Oklahoma,1975,Y,N
11,4,0,7,Big 8,,Oklahoma State,1975,N,N
11,5,0,6,SEC,,Ole Miss,1975,N,N
11,8,0,3,Pac-8,,Oregon,1975,N,N
11,10,0,1,Pac-8,,Oregon State,1975,N,N
12,6,0,6,PCAA,,Pacific,1975,N,N
12,3,0,9,FBS Independents,,Penn State,1975,N,N
9,6,0,3,Ivy,,Pennsylvania,1975,N,N
12,4,0,8,FBS Independents,,Pittsburgh,1975,N,N
9,5,0,4,Ivy,,Princeton,1975,N,N
11,7,0,4,Big Ten,,Purdue,1975,N,N
11,9,0,2,Southwest,,Rice,1975,N,N
11,6,0,5,Southern,,Richmond,1975,N,N
11,2,0,9,FBS Independents,,Rutgers,1975,N,N
11,3,0,8,PCAA,,San Diego State,1975,N,N
11,2,0,9,PCAA,,San Josï¿½ State,1975,N,N
11,7,0,4,Southwest,,SMU,1975,N,N
12,5,0,7,FBS Independents,,South Carolina,1975,N,N
11,9,0,2,FBS Independents,,Southern Illinois,1975,N,N
11,4,0,7,FBS Independents,,Southern Mississippi,1975,N,N
11,4,0,7,Pac-8,,Stanford,1975,N,N
11,5,0,6,FBS Independents,,Syracuse,1975,N,N
11,10,0,1,Southwest,,TCU,1975,N,N
11,5,0,6,FBS Independents,,Temple,1975,N,N
12,5,0,7,SEC,,Tennessee,1975,N,N
12,2,0,10,Southwest,,Texas,1975,N,N
12,2,0,10,Southwest,,Texas A&M,1975,N,N
11,7,0,4,Southland,,Texas-Arlington,1975,N,N
11,5,0,6,Southwest,,Texas Tech,1975,N,N
11,5,0,6,Southern,,The Citadel,1975,N,N
11,6,0,5,Mid-American,,Toledo,1975,N,N
11,7,0,4,FBS Independents,,Tulane,1975,N,N
11,4,0,7,Missouri Valley,,Tulsa,1975,N,N
12,2,0,10,Pac-8,,UCLA,1975,N,N
12,4,0,8,Pac-8,,USC,1975,N,N
11,10,0,1,Western Athletic,,Utah,1975,N,N
11,5,0,6,FBS Independents,,Utah State,1975,N,N
11,10,0,1,Western Athletic,,UTEP,1975,N,N
11,4,0,7,SEC,,Vanderbilt,1975,N,N
11,7,0,4,FBS Independents,,Villanova,1975,N,N
11,10,0,1,ACC,,Virginia,1975,N,N
11,3,0,8,FBS Independents,,Virginia Tech,1975,N,N
11,8,0,3,Southern,,VMI,1975,N,N
11,8,0,3,ACC,,Wake Forest,1975,N,N
11,5,0,6,Pac-8,,Washington,1975,N,N
11,8,0,3,Pac-8,,Washington State,1975,N,N
11,10,0,1,Mid-American,,Western Michigan,1975,N,N
11,6,0,5,Missouri Valley,,West Texas A&M,1975,N,N
12,3,0,9,FBS Independents,,West Virginia,1975,N,N
11,8,0,3,Missouri Valley,,Wichita State,1975,N,N
11,9,0,2,Southern,,William & Mary,1975,N,N
11,7,0,4,Big Ten,,Wisconsin,1975,N,N
11,9,0,2,Western Athletic,,Wyoming,1975,N,N
9,2,0,7,Ivy,,Yale,1975,N,N
11,7,0,4,FBS Independents,,Air Force,1976,N,N
12,3,0,9,SEC,,Alabama,1976,N,N
11,5,0,6,Southern,,Appalachian State,1976,N,N
11,6,0,5,Western Athletic,,Arizona,1976,N,N
11,7,0,4,Western Athletic,,Arizona State,1976,N,N
11,5,0,6,Southwest,,Arkansas,1976,N,N
11,6,0,5,Southland,,Arkansas State,1976,N,N
11,6,0,5,FBS Independents,,Army,1976,N,N
11,8,0,3,SEC,,Auburn,1976,N,N
11,3,0,8,Mid-American,,Ball State,1976,N,N
11,4,0,7,Southwest,,Baylor,1976,N,N
11,3,0,8,FBS Independents,,Boston College,1976,N,N
11,5,0,6,Mid-American,,Bowling Green,1976,N,N
9,1,0,8,Ivy,,Brown,1976,N,N
12,3,0,9,Western Athletic,,BYU,1976,N,N
11,6,0,5,Pac-8,,California,1976,N,N
11,7,0,4,PCAA,,Cal State Fullerton,1976,N,N
11,4,0,7,Mid-American,,Central Michigan,1976,N,N
11,4,0,7,FBS Independents,,Chattanooga,1976,N,N
11,3,0,8,FBS Independents,,Cincinnati,1976,N,N
11,7,0,4,ACC,,Clemson,1976,N,N
10,2,0,8,FBS Independents,,Colgate,1976,N,N
12,4,0,8,Big 8,,Colorado,1976,N,N
11,5,0,6,Western Athletic,,Colorado State,1976,N,N
9,6,0,3,Ivy,,Columbia,1976,N,N
9,7,0,2,Ivy,,Cornell,1976,N,N
9,3,0,6,Ivy,,Dartmouth,1976,N,N
11,7,0,4,FBS Independents,,Dayton,1976,N,N
11,10,0,1,Missouri Valley,,Drake,1976,N,N
11,5,0,6,ACC,,Duke,1976,N,N
11,2,0,9,Southern,,East Carolina,1976,N,N
11,9,0,2,Mid-American,,Eastern Michigan,1976,N,N
12,4,0,8,SEC,,Florida,1976,N,N
11,6,0,5,FBS Independents,,Florida State,1976,N,N
11,6,0,5,PCAA,,Fresno State,1976,N,N
11,4,0,7,Southern,,Furman,1976,N,N
12,2,0,10,SEC,,Georgia,1976,N,N
11,7,0,4,FBS Independents,,Georgia Tech,1976,N,N
9,3,0,6,Ivy,,Harvard,1976,N,N
11,8,0,3,FBS Independents,,Hawai'i,1976,N,N
11,8,0,3,FBS Independents,,Holy Cross,1976,N,N
12,2,0,10,Southwest,,Houston,1976,N,N
11,6,0,5,Big Ten,,Illinois,1976,N,N
11,6,0,5,FBS Independents,,Illinois State,1976,N,N
11,6,0,5,Big Ten,,Indiana,1976,N,N
10,7,0,3,FBS Independents,,Indiana State,1976,N,N
11,6,0,5,Big Ten,,Iowa,1976,N,N
11,3,0,8,Big 8,,Iowa State,1976,N,N
11,5,0,6,Big 8,,Kansas,1976,N,N
11,10,0,1,Big 8,,Kansas State,1976,N,N
12,4,0,8,Mid-American,,Kent State,1976,N,N
12,4,0,8,SEC,,Kentucky,1976,N,N
11,9,0,2,Southland,,Lamar,1976,N,N
11,3,0,8,PCAA,,Long Beach State,1976,N,N
11,2,0,9,Southland,,Louisiana,1976,N,N
11,9,0,2,FBS Independents,,Louisiana Monroe,1976,N,N
11,5,0,6,Southland,,Louisiana Tech,1976,N,N
11,7,0,4,FBS Independents,,Louisville,1976,N,N
11,5,0,6,SEC,,LSU,1976,N,N
11,7,0,4,FBS Independents,,Marshall,1976,N,N
12,1,0,11,ACC,,Maryland,1976,N,N
12,2,0,10,Southland,,McNeese,1976,N,N
11,4,0,7,FBS Independents,,Memphis,1976,N,N
11,8,0,3,FBS Independents,,Miami,1976,N,N
11,8,0,3,Mid-American,,Miami (OH),1976,N,N
12,2,0,10,Big Ten,,Michigan,1976,N,N
11,6,0,5,Big Ten,,Michigan State,1976,N,N
11,5,0,6,Big Ten,,Minnesota,1976,N,N
11,2,0,9,SEC,,Mississippi State,1976,N,N
11,5,0,6,Big 8,,Missouri,1976,N,N
11,7,0,4,FBS Independents,,Navy,1976,N,N
11,8,0,3,ACC,,NC State,1976,N,N
13,3,0,10,Big 8,,Nebraska,1976,N,N
11,7,0,4,Western Athletic,,New Mexico,1976,N,N
11,7,0,4,Missouri Valley,,New Mexico State,1976,N,N
12,3,0,9,ACC,,North Carolina,1976,N,N
11,10,0,1,Mid-American,,Northern Illinois,1976,N,N
11,5,0,6,FBS Independents,,North Texas,1976,N,N
11,10,0,1,Big Ten,,Northwestern,1976,N,N
10,5,0,5,FBS Independents,,Northwestern State,1976,N,N
12,3,0,9,FBS Independents,,Notre Dame,1976,N,N
11,4,0,7,Mid-American,,Ohio,1976,N,N
12,3,0,9,Big Ten,,Ohio State,1976,N,N
12,3,0,9,Big 8,,Oklahoma,1976,N,N
12,3,0,9,Big 8,,Oklahoma State,1976,N,N
11,6,0,5,SEC,,Ole Miss,1976,N,N
11,7,0,4,Pac-8,,Oregon,1976,N,N
12,10,0,2,Pac-8,,Oregon State,1976,N,N
11,9,0,2,PCAA,,Pacific,1976,N,N
12,5,0,7,FBS Independents,,Penn State,1976,N,N
9,6,0,3,Ivy,,Pennsylvania,1976,N,N
12,0,0,12,FBS Independents,,Pittsburgh,1976,Y,N
9,7,0,2,Ivy,,Princeton,1976,N,N
11,6,0,5,Big Ten,,Purdue,1976,N,N
11,8,0,3,Southwest,,Rice,1976,N,N
11,6,0,5,Southern,,Richmond,1976,N,N
11,0,0,11,FBS Independents,,Rutgers,1976,N,N
11,1,0,10,FBS Independents,,San Diego State,1976,N,N
11,4,0,7,PCAA,,San Josï¿½ State,1976,N,N
11,8,0,3,Southwest,,SMU,1976,N,N
11,5,0,6,FBS Independents,,South Carolina,1976,N,N
11,4,0,7,FBS Independents,,Southern Illinois,1976,N,N
11,9,0,2,FBS Independents,,Southern Mississippi,1976,N,N
11,5,0,6,Pac-8,,Stanford,1976,N,N
11,8,0,3,FBS Independents,,Syracuse,1976,N,N
11,11,0,0,Southwest,,TCU,1976,N,N
10,6,0,4,FBS Independents,,Temple,1976,N,N
11,5,0,6,SEC,,Tennessee,1976,N,N
11,5,0,6,Southwest,,Texas,1976,N,N
12,2,0,10,Southwest,,Texas A&M,1976,N,N
11,6,0,5,Southland,,Texas-Arlington,1976,N,N
12,2,0,10,Southwest,,Texas Tech,1976,N,N
11,5,0,6,Southern,,The Citadel,1976,N,N
11,8,0,3,Mid-American,,Toledo,1976,N,N
11,9,0,2,FBS Independents,,Tulane,1976,N,N
12,5,0,7,Missouri Valley,,Tulsa,1976,N,N
12,2,0,10,Pac-8,,UCLA,1976,N,N
12,1,0,11,Pac-8,,USC,1976,N,N
11,8,0,3,Western Athletic,,Utah,1976,N,N
11,8,0,3,FBS Independents,,Utah State,1976,N,N
12,11,0,1,Western Athletic,,UTEP,1976,N,N
11,9,0,2,SEC,,Vanderbilt,1976,N,N
11,4,0,7,FBS Independents,,Villanova,1976,N,N
11,9,0,2,ACC,,Virginia,1976,N,N
11,5,0,6,FBS Independents,,Virginia Tech,1976,N,N
10,5,0,5,Southern,,VMI,1976,N,N
11,6,0,5,ACC,,Wake Forest,1976,N,N
11,6,0,5,Pac-8,,Washington,1976,N,N
11,8,0,3,Pac-8,,Washington State,1976,N,N
11,4,0,7,Mid-American,,Western Michigan,1976,N,N
11,5,0,6,Missouri Valley,,West Texas A&M,1976,N,N
11,6,0,5,FBS Independents,,West Virginia,1976,N,N
11,7,0,4,Missouri Valley,,Wichita State,1976,N,N
11,4,0,7,Southern,,William & Mary,1976,N,N
11,6,0,5,Big Ten,,Wisconsin,1976,N,N
12,4,0,8,Western Athletic,,Wyoming,1976,N,N
9,1,0,8,Ivy,,Yale,1976,N,N
11,8,0,3,FBS Independents,,Air Force,1977,N,N
12,1,0,11,SEC,,Alabama,1977,N,N
11,8,0,3,SWAC,,Alcorn State,1977,N,N
11,9,0,2,Southern,,Appalachian State,1977,N,N
12,7,0,5,Western Athletic,,Arizona,1977,N,N
12,3,0,9,Western Athletic,,Arizona State,1977,N,N
12,1,0,11,Southwest,,Arkansas,1977,N,N
11,4,0,7,Southland,,Arkansas State,1977,N,N
11,4,0,7,FBS Independents,,Army,1977,N,N
11,6,0,5,SEC,,Auburn,1977,N,N
11,2,0,9,Mid-American,,Ball State,1977,N,N
11,6,0,5,Southwest,,Baylor,1977,N,N
11,5,0,6,FBS Independents,,Boston College,1977,N,N
12,7,0,5,Mid-American,,Bowling Green,1977,N,N
9,2,0,7,Ivy,,Brown,1977,N,N
11,2,0,9,Western Athletic,,BYU,1977,N,N
11,4,0,7,Pac-8,,California,1977,N,N
11,7,0,4,PCAA,,Cal State Fullerton,1977,N,N
11,1,0,10,Mid-American,,Central Michigan,1977,N,N
11,2,0,9,Southern,,Chattanooga,1977,N,N
11,5,0,6,FBS Independents,,Cincinnati,1977,N,N
12,3,0,9,ACC,,Clemson,1977,N,N
11,1,0,10,FBS Independents,,Colgate,1977,N,N
11,3,0,8,Big 8,,Colorado,1977,N,N
12,2,0,10,Western Athletic,,Colorado State,1977,N,N
9,7,0,2,Ivy,,Columbia,1977,N,N
9,8,0,1,Ivy,,Cornell,1977,N,N
9,3,0,6,Ivy,,Dartmouth,1977,N,N
11,9,0,2,Missouri Valley,,Drake,1977,N,N
11,6,0,5,ACC,,Duke,1977,N,N
11,3,0,8,FBS Independents,,East Carolina,1977,N,N
11,3,0,8,Mid-American,,Eastern Michigan,1977,N,N
11,5,0,6,SEC,,Florida,1977,N,N
12,2,0,10,FBS Independents,,Florida State,1977,N,N
11,2,0,9,PCAA,,Fresno State,1977,N,N
11,7,0,4,Southern,,Furman,1977,N,N
11,6,0,5,SEC,,Georgia,1977,N,N
11,5,0,6,FBS Independents,,Georgia Tech,1977,N,N
11,1,0,10,SWAC,,Grambling,1977,N,N
9,5,0,4,Ivy,,Harvard,1977,N,N
11,6,0,5,FBS Independents,,Hawai'i,1977,N,N
11,9,0,2,FBS Independents,,Holy Cross,1977,N,N
11,5,0,6,Southwest,,Houston,1977,N,N
11,8,0,3,Big Ten,,Illinois,1977,N,N
11,8,0,3,FBS Independents,,Illinois State,1977,N,N
11,6,0,5,Big Ten,,Indiana,1977,N,N
10,7,0,3,FBS Independents,,Indiana State,1977,N,N
11,7,0,4,Big Ten,,Iowa,1977,N,N
12,4,0,8,Big 8,,Iowa State,1977,N,N
11,3,0,8,SWAC,,Jackson State,1977,N,N
11,8,0,3,Big 8,,Kansas,1977,N,N
11,10,0,1,Big 8,,Kansas State,1977,N,N
11,5,0,6,Mid-American,,Kent State,1977,N,N
11,1,0,10,SEC,,Kentucky,1977,N,N
11,9,0,2,Southland,,Lamar,1977,N,N
10,6,0,4,PCAA,,Long Beach State,1977,N,N
12,5,0,7,Southland,,Louisiana,1977,N,N
11,9,0,2,FBS Independents,,Louisiana Monroe,1977,N,N
12,2,0,10,Southland,,Louisiana Tech,1977,N,N
12,5,0,7,FBS Independents,,Louisville,1977,N,N
12,4,0,8,SEC,,LSU,1977,N,N
11,9,0,2,Southern,,Marshall,1977,N,N
12,4,0,8,ACC,,Maryland,1977,N,N
11,5,0,6,Southland,,McNeese,1977,N,N
11,5,0,6,FBS Independents,,Memphis,1977,N,N
11,8,0,3,FBS Independents,,Miami,1977,N,N
11,1,0,10,Mid-American,,Miami (OH),1977,N,N
12,2,0,10,Big Ten,,Michigan,1977,N,N
11,3,0,8,Big Ten,,Michigan State,1977,N,N
12,5,0,7,Big Ten,,Minnesota,1977,N,N
11,6,0,5,SEC,,Mississippi State,1977,N,N
10,5,0,5,SWAC,,Mississippi Valley State,1977,N,N
11,7,0,4,Big 8,,Missouri,1977,N,N
11,6,0,5,FBS Independents,,Navy,1977,N,N
12,4,0,8,ACC,,NC State,1977,N,N
12,3,0,9,Big 8,,Nebraska,1977,N,N
12,7,0,5,Western Athletic,,New Mexico,1977,N,N
11,7,0,4,Missouri Valley,,New Mexico State,1977,N,N
12,4,0,8,ACC,,North Carolina,1977,N,N
11,8,0,3,Mid-American,,Northern Illinois,1977,N,N
11,2,0,9,FBS Independents,,North Texas,1977,N,N
11,10,0,1,Big Ten,,Northwestern,1977,N,N
11,5,0,6,FBS Independents,,Northwestern State,1977,N,N
12,1,0,11,FBS Independents,,Notre Dame,1977,Y,N
11,10,0,1,Mid-American,,Ohio,1977,N,N
12,3,0,9,Big Ten,,Ohio State,1977,N,N
12,2,0,10,Big 8,,Oklahoma,1977,N,N
11,7,0,4,Big 8,,Oklahoma State,1977,N,N
11,6,0,5,SEC,,Ole Miss,1977,N,N
11,9,0,2,Pac-8,,Oregon,1977,N,N
11,9,0,2,Pac-8,,Oregon State,1977,N,N
11,5,0,6,PCAA,,Pacific,1977,N,N
12,1,0,11,FBS Independents,,Penn State,1977,N,N
9,4,0,5,Ivy,,Pennsylvania,1977,N,N
12,2,0,10,FBS Independents,,Pittsburgh,1977,N,N
11,8,0,3,SWAC,,Prairie View,1977,N,N
9,6,0,3,Ivy,,Princeton,1977,N,N
11,6,0,5,Big Ten,,Purdue,1977,N,N
11,10,0,1,Southwest,,Rice,1977,N,N
11,8,0,3,FBS Independents,,Richmond,1977,N,N
11,3,0,8,FBS Independents,,Rutgers,1977,N,N
11,1,0,10,FBS Independents,,San Diego State,1977,N,N
11,7,0,4,PCAA,,San Josï¿½ State,1977,N,N
11,7,0,4,Southwest,,SMU,1977,N,N
12,7,0,5,FBS Independents,,South Carolina,1977,N,N
11,8,0,3,SWAC,,Southern,1977,N,N
11,8,0,3,Missouri Valley,,Southern Illinois,1977,N,N
12,6,0,6,FBS Independents,,Southern Mississippi,1977,N,N
12,3,0,9,Pac-8,,Stanford,1977,N,N
11,5,0,6,FBS Independents,,Syracuse,1977,N,N
11,9,0,2,Southwest,,TCU,1977,N,N
11,5,0,6,FBS Independents,,Temple,1977,N,N
11,7,0,4,SEC,,Tennessee,1977,N,N
10,1,0,9,FBS Independents,,Tennessee State,1977,N,N
12,1,0,11,Southwest,,Texas,1977,N,N
12,4,0,8,Southwest,,Texas A&M,1977,N,N
11,6,0,5,Southland,,Texas-Arlington,1977,N,N
11,4,0,7,SWAC,,Texas Southern,1977,N,N
12,5,0,7,Southwest,,Texas Tech,1977,N,N
11,6,0,5,Southern,,The Citadel,1977,N,N
11,9,0,2,Mid-American,,Toledo,1977,N,N
11,8,0,3,FBS Independents,,Tulane,1977,N,N
11,8,0,3,Missouri Valley,,Tulsa,1977,N,N
11,4,0,7,Pac-8,,UCLA,1977,N,N
12,4,0,8,Pac-8,,USC,1977,N,N
11,8,0,3,Western Athletic,,Utah,1977,N,N
11,7,0,4,FBS Independents,,Utah State,1977,N,N
11,10,0,1,Western Athletic,,UTEP,1977,N,N
11,9,0,2,SEC,,Vanderbilt,1977,N,N
11,7,0,4,FBS Independents,,Villanova,1977,N,N
11,9,0,2,ACC,,Virginia,1977,N,N
11,8,0,3,FBS Independents,,Virginia Tech,1977,N,N
11,4,0,7,Southern,,VMI,1977,N,N
11,10,0,1,ACC,,Wake Forest,1977,N,N
12,4,0,8,Pac-8,,Washington,1977,N,N
11,5,0,6,Pac-8,,Washington State,1977,N,N
11,4,0,7,Southern,,Western Carolina,1977,N,N
11,7,0,4,Mid-American,,Western Michigan,1977,N,N
11,5,0,6,Missouri Valley,,West Texas A&M,1977,N,N
11,6,0,5,FBS Independents,,West Virginia,1977,N,N
11,6,0,5,Missouri Valley,,Wichita State,1977,N,N
11,5,0,6,FBS Independents,,William & Mary,1977,N,N
11,6,0,5,Big Ten,,Wisconsin,1977,N,N
11,7,0,4,Western Athletic,,Wyoming,1977,N,N
9,2,0,7,Ivy,,Yale,1977,N,N
11,8,0,3,FBS Independents,,Air Force,1978,N,N
12,1,0,11,SEC,,Alabama,1978,Y,N
11,4,0,7,Southern,,Appalachian State,1978,N,N
11,6,0,5,Pac-10,,Arizona,1978,N,N
12,3,0,9,Pac-10,,Arizona State,1978,N,N
12,3,0,9,Southwest,,Arkansas,1978,N,N
11,4,0,7,Southland,,Arkansas State,1978,N,N
11,7,0,4,FBS Independents,,Army,1978,N,N
11,5,0,6,SEC,,Auburn,1978,N,N
11,1,0,10,Mid-American,,Ball State,1978,N,N
11,8,0,3,Southwest,,Baylor,1978,N,N
11,11,0,0,FBS Independents,,Boston College,1978,N,N
11,7,0,4,Mid-American,,Bowling Green,1978,N,N
9,3,0,6,Ivy,,Brown,1978,N,N
13,4,0,9,Western Athletic,,BYU,1978,N,N
11,5,0,6,Pac-10,,California,1978,N,N
12,7,0,5,PCAA,,Cal State Fullerton,1978,N,N
11,2,0,9,Mid-American,,Central Michigan,1978,N,N
11,3,0,8,Southern,,Chattanooga,1978,N,N
11,6,0,5,FBS Independents,,Cincinnati,1978,N,N
12,1,0,11,ACC,,Clemson,1978,N,N
11,8,0,3,FBS Independents,,Colgate,1978,N,N
11,5,0,6,Big 8,,Colorado,1978,N,N
11,6,0,5,Western Athletic,,Colorado State,1978,N,N
9,5,0,4,Ivy,,Columbia,1978,N,N
9,4,0,5,Ivy,,Cornell,1978,N,N
9,3,0,6,Ivy,,Dartmouth,1978,N,N
11,7,0,4,Missouri Valley,,Drake,1978,N,N
11,7,0,4,ACC,,Duke,1978,N,N
12,3,0,9,FBS Independents,,East Carolina,1978,N,N
10,7,0,3,Mid-American,,Eastern Michigan,1978,N,N
11,7,0,4,SEC,,Florida,1978,N,N
11,3,0,8,FBS Independents,,Florida State,1978,N,N
11,8,0,3,PCAA,,Fresno State,1978,N,N
11,3,0,8,Southern,,Furman,1978,N,N
12,2,0,10,SEC,,Georgia,1978,N,N
12,5,0,7,FBS Independents,,Georgia Tech,1978,N,N
9,4,0,5,Ivy,,Harvard,1978,N,N
11,5,0,6,FBS Independents,,Hawai'i,1978,N,N
11,4,0,7,FBS Independents,,Holy Cross,1978,N,N
12,3,0,9,Southwest,,Houston,1978,N,N
11,10,0,1,Big Ten,,Illinois,1978,N,N
11,9,0,2,FBS Independents,,Illinois State,1978,N,N
11,7,0,4,Big Ten,,Indiana,1978,N,N
11,8,0,3,Missouri Valley,,Indiana State,1978,N,N
11,9,0,2,Big Ten,,Iowa,1978,N,N
12,4,0,8,Big 8,,Iowa State,1978,N,N
11,10,0,1,Big 8,,Kansas,1978,N,N
11,7,0,4,Big 8,,Kansas State,1978,N,N
11,7,0,4,Mid-American,,Kent State,1978,N,N
11,6,0,5,SEC,,Kentucky,1978,N,N
11,9,0,2,Southland,,Lamar,1978,N,N
11,6,0,5,PCAA,,Long Beach State,1978,N,N
11,8,0,3,Southland,,Louisiana,1978,N,N
11,4,0,7,FBS Independents,,Louisiana Monroe,1978,N,N
11,5,0,6,Southland,,Louisiana Tech,1978,N,N
11,4,0,7,FBS Independents,,Louisville,1978,N,N
12,4,0,8,SEC,,LSU,1978,N,N
11,10,0,1,Southern,,Marshall,1978,N,N
12,3,0,9,ACC,,Maryland,1978,N,N
11,4,0,7,Southland,,McNeese,1978,N,N
11,7,0,4,FBS Independents,,Memphis,1978,N,N
11,5,0,6,FBS Independents,,Miami,1978,N,N
11,3,0,8,Mid-American,,Miami (OH),1978,N,N
12,2,0,10,Big Ten,,Michigan,1978,N,N
11,3,0,8,Big Ten,,Michigan State,1978,N,N
11,6,0,5,Big Ten,,Minnesota,1978,N,N
11,5,0,6,SEC,,Mississippi State,1978,N,N
12,4,0,8,Big 8,,Missouri,1978,N,N
12,3,0,9,FBS Independents,,Navy,1978,N,N
12,3,0,9,ACC,,NC State,1978,N,N
12,3,0,9,Big 8,,Nebraska,1978,N,N
12,5,0,7,Western Athletic,,New Mexico,1978,N,N
11,5,0,6,Missouri Valley,,New Mexico State,1978,N,N
11,6,0,5,ACC,,North Carolina,1978,N,N
11,6,0,5,Mid-American,,Northern Illinois,1978,N,N
11,2,0,9,FBS Independents,,North Texas,1978,N,N
11,10,0,1,Big Ten,,Northwestern,1978,N,N
11,6,0,5,FBS Independents,,Northwestern State,1978,N,N
12,3,0,9,FBS Independents,,Notre Dame,1978,N,N
11,8,0,3,Mid-American,,Ohio,1978,N,N
12,5,0,7,Big Ten,,Ohio State,1978,N,N
12,1,0,11,Big 8,,Oklahoma,1978,N,N
11,8,0,3,Big 8,,Oklahoma State,1978,N,N
11,6,0,5,SEC,,Ole Miss,1978,N,N
11,9,0,2,Pac-10,,Oregon,1978,N,N
11,7,0,4,Pac-10,,Oregon State,1978,N,N
12,8,0,4,PCAA,,Pacific,1978,N,N
12,1,0,11,FBS Independents,,Penn State,1978,N,N
9,7,0,2,Ivy,,Pennsylvania,1978,N,N
12,4,0,8,FBS Independents,,Pittsburgh,1978,N,N
9,6,0,3,Ivy,,Princeton,1978,N,N
12,2,0,10,Big Ten,,Purdue,1978,N,N
11,9,0,2,Southwest,,Rice,1978,N,N
11,8,0,3,FBS Independents,,Richmond,1978,N,N
12,3,0,9,FBS Independents,,Rutgers,1978,N,N
11,7,0,4,Western Athletic,,San Diego State,1978,N,N
12,5,0,7,PCAA,,San Josï¿½ State,1978,N,N
11,6,0,5,Southwest,,SMU,1978,N,N
11,6,0,5,FBS Independents,,South Carolina,1978,N,N
11,4,0,7,Missouri Valley,,Southern Illinois,1978,N,N
11,4,0,7,FBS Independents,,Southern Mississippi,1978,N,N
12,4,0,8,Pac-10,,Stanford,1978,N,N
11,8,0,3,FBS Independents,,Syracuse,1978,N,N
11,9,0,2,Southwest,,TCU,1978,N,N
11,3,0,8,FBS Independents,,Temple,1978,N,N
11,6,0,5,SEC,,Tennessee,1978,N,N
12,3,0,9,Southwest,,Texas,1978,N,N
12,4,0,8,Southwest,,Texas A&M,1978,N,N
11,6,0,5,Southland,,Texas-Arlington,1978,N,N
11,4,0,7,Southwest,,Texas Tech,1978,N,N
11,6,0,5,Southern,,The Citadel,1978,N,N
11,9,0,2,Mid-American,,Toledo,1978,N,N
11,7,0,4,FBS Independents,,Tulane,1978,N,N
11,2,0,9,Missouri Valley,,Tulsa,1978,N,N
12,3,0,9,Pac-10,,UCLA,1978,N,N
11,4,0,7,FBS Independents,,UNLV,1978,N,N
13,1,0,12,Pac-10,,USC,1978,Y,N
11,3,0,8,Western Athletic,,Utah,1978,N,N
11,4,0,7,PCAA,,Utah State,1978,N,N
12,11,0,1,Western Athletic,,UTEP,1978,N,N
11,9,0,2,SEC,,Vanderbilt,1978,N,N
11,6,0,5,FBS Independents,,Villanova,1978,N,N
11,9,0,2,ACC,,Virginia,1978,N,N
11,7,0,4,FBS Independents,,Virginia Tech,1978,N,N
11,8,0,3,Southern,,VMI,1978,N,N
11,10,0,1,ACC,,Wake Forest,1978,N,N
11,4,0,7,Pac-10,,Washington,1978,N,N
11,7,0,4,Pac-10,,Washington State,1978,N,N
11,5,0,6,Southern,,Western Carolina,1978,N,N
11,4,0,7,Mid-American,,Western Michigan,1978,N,N
11,8,0,3,Missouri Valley,,West Texas A&M,1978,N,N
11,9,0,2,FBS Independents,,West Virginia,1978,N,N
11,7,0,4,Missouri Valley,,Wichita State,1978,N,N
11,6,0,5,FBS Independents,,William & Mary,1978,N,N
11,5,0,6,Big Ten,,Wisconsin,1978,N,N
12,7,0,5,Western Athletic,,Wyoming,1978,N,N
9,3,0,6,Ivy,,Yale,1978,N,N
11,9,0,2,FBS Independents,,Air Force,1979,N,N
12,0,0,12,SEC,,Alabama,1979,Y,N
11,8,0,3,Southern,,Appalachian State,1979,N,N
12,6,0,6,Pac-10,,Arizona,1979,N,N
12,6,0,6,Pac-10,,Arizona State,1979,N,N
12,2,0,10,Southwest,,Arkansas,1979,N,N
11,7,0,4,Southland,,Arkansas State,1979,N,N
11,9,0,2,FBS Independents,,Army,1979,N,N
11,3,0,8,SEC,,Auburn,1979,N,N
11,5,0,6,Mid-American,,Ball State,1979,N,N
12,4,0,8,Southwest,,Baylor,1979,N,N
11,6,0,5,FBS Independents,,Boston College,1979,N,N
11,7,0,4,Mid-American,,Bowling Green,1979,N,N
9,3,0,6,Ivy,,Brown,1979,N,N
12,1,0,11,Western Athletic,,BYU,1979,N,N
12,6,0,6,Pac-10,,California,1979,N,N
11,8,0,3,PCAA,,Cal State Fullerton,1979,N,N
11,0,0,11,Mid-American,,Central Michigan,1979,N,N
11,2,0,9,Southern,,Chattanooga,1979,N,N
11,9,0,2,FBS Independents,,Cincinnati,1979,N,N
12,4,0,8,ACC,,Clemson,1979,N,N
10,4,0,6,FBS Independents,,Colgate,1979,N,N
11,8,0,3,Big 8,,Colorado,1979,N,N
12,7,0,5,Western Athletic,,Colorado State,1979,N,N
9,8,0,1,Ivy,,Columbia,1979,N,N
11,7,0,4,FBS Independents,,Connecticut,1979,N,N
9,4,0,5,Ivy,,Cornell,1979,N,N
9,4,0,5,Ivy,,Dartmouth,1979,N,N
11,8,0,3,Missouri Valley,,Drake,1979,N,N
11,8,0,3,ACC,,Duke,1979,N,N
11,3,0,8,FBS Independents,,East Carolina,1979,N,N
11,9,0,2,Mid-American,,Eastern Michigan,1979,N,N
11,4,0,7,Southern,,East Tennessee State,1979,N,N
11,11,0,0,SEC,,Florida,1979,N,N
12,1,0,11,FBS Independents,,Florida State,1979,N,N
11,7,0,4,PCAA,,Fresno State,1979,N,N
11,6,0,5,Southern,,Furman,1979,N,N
11,5,0,6,SEC,,Georgia,1979,N,N
11,6,0,5,FBS Independents,,Georgia Tech,1979,N,N
9,6,0,3,Ivy,,Harvard,1979,N,N
11,5,0,6,Western Athletic,,Hawai'i,1979,N,N
11,6,0,5,FBS Independents,,Holy Cross,1979,N,N
12,1,0,11,Southwest,,Houston,1979,N,N
11,8,0,3,Big Ten,,Illinois,1979,N,N
11,8,0,3,FBS Independents,,Illinois State,1979,N,N
12,4,0,8,Big Ten,,Indiana,1979,N,N
11,3,0,8,Missouri Valley,,Indiana State,1979,N,N
11,6,0,5,Big Ten,,Iowa,1979,N,N
11,8,0,3,Big 8,,Iowa State,1979,N,N
11,8,0,3,Big 8,,Kansas,1979,N,N
11,8,0,3,Big 8,,Kansas State,1979,N,N
11,10,0,1,Mid-American,,Kent State,1979,N,N
11,6,0,5,SEC,,Kentucky,1979,N,N
11,4,0,7,Southland,,Lamar,1979,N,N
11,4,0,7,PCAA,,Long Beach State,1979,N,N
11,7,0,4,Southland,,Louisiana,1979,N,N
11,8,0,3,FBS Independents,,Louisiana Monroe,1979,N,N
11,9,0,2,Southland,,Louisiana Tech,1979,N,N
11,7,0,4,FBS Independents,,Louisville,1979,N,N
12,5,0,7,SEC,,LSU,1979,N,N
11,10,0,1,Southern,,Marshall,1979,N,N
11,4,0,7,ACC,,Maryland,1979,N,N
12,1,0,11,Southland,,McNeese,1979,N,N
11,6,0,5,FBS Independents,,Memphis,1979,N,N
11,6,0,5,FBS Independents,,Miami,1979,N,N
11,5,0,6,Mid-American,,Miami (OH),1979,N,N
12,4,0,8,Big Ten,,Michigan,1979,N,N
11,6,0,5,Big Ten,,Michigan State,1979,N,N
11,7,0,4,Big Ten,,Minnesota,1979,N,N
11,8,0,3,SEC,,Mississippi State,1979,N,N
12,5,0,7,Big 8,,Missouri,1979,N,N
11,4,0,7,FBS Independents,,Navy,1979,N,N
11,4,0,7,ACC,,NC State,1979,N,N
12,2,0,10,Big 8,,Nebraska,1979,N,N
12,6,0,6,Western Athletic,,New Mexico,1979,N,N
11,9,0,2,Missouri Valley,,New Mexico State,1979,N,N
12,4,0,8,ACC,,North Carolina,1979,N,N
11,5,0,6,Mid-American,,Northern Illinois,1979,N,N
11,6,0,5,FBS Independents,,North Texas,1979,N,N
11,10,0,1,Big Ten,,Northwestern,1979,N,N
9,6,0,3,FBS Independents,,Northwestern State,1979,N,N
11,4,0,7,FBS Independents,,Notre Dame,1979,N,N
11,5,0,6,Mid-American,,Ohio,1979,N,N
12,1,0,11,Big Ten,,Ohio State,1979,N,N
12,1,0,11,Big 8,,Oklahoma,1979,N,N
11,4,0,7,Big 8,,Oklahoma State,1979,N,N
11,7,0,4,SEC,,Ole Miss,1979,N,N
11,5,0,6,Pac-10,,Oregon,1979,N,N
11,10,0,1,Pac-10,,Oregon State,1979,N,N
10,7,0,3,PCAA,,Pacific,1979,N,N
12,4,0,8,FBS Independents,,Penn State,1979,N,N
9,9,0,0,Ivy,,Pennsylvania,1979,N,N
12,1,0,11,FBS Independents,,Pittsburgh,1979,N,N
9,4,0,5,Ivy,,Princeton,1979,N,N
12,2,0,10,Big Ten,,Purdue,1979,N,N
11,10,0,1,Southwest,,Rice,1979,N,N
11,11,0,0,FBS Independents,,Richmond,1979,N,N
11,3,0,8,FBS Independents,,Rutgers,1979,N,N
11,3,0,8,Western Athletic,,San Diego State,1979,N,N
11,5,0,6,PCAA,,San Josï¿½ State,1979,N,N
11,6,0,5,Southwest,,SMU,1979,N,N
12,4,0,8,FBS Independents,,South Carolina,1979,N,N
11,3,0,8,Missouri Valley,,Southern Illinois,1979,N,N
11,4,0,7,FBS Independents,,Southern Mississippi,1979,N,N
11,5,0,6,Pac-10,,Stanford,1979,N,N
12,5,0,7,FBS Independents,,Syracuse,1979,N,N
11,8,0,3,Southwest,,TCU,1979,N,N
12,2,0,10,FBS Independents,,Temple,1979,N,N
12,5,0,7,SEC,,Tennessee,1979,N,N
12,3,0,9,Southwest,,Texas,1979,N,N
11,5,0,6,Southwest,,Texas A&M,1979,N,N
11,2,0,9,Southland,,Texas-Arlington,1979,N,N
11,7,0,4,Southwest,,Texas Tech,1979,N,N
11,5,0,6,Southern,,The Citadel,1979,N,N
11,4,0,7,Mid-American,,Toledo,1979,N,N
12,3,0,9,FBS Independents,,Tulane,1979,N,N
11,5,0,6,Missouri Valley,,Tulsa,1979,N,N
11,6,0,5,Pac-10,,UCLA,1979,N,N
12,3,0,9,FBS Independents,,UNLV,1979,N,N
12,1,0,11,Pac-10,,USC,1979,N,N
12,6,0,6,Western Athletic,,Utah,1979,N,N
11,3,0,8,PCAA,,Utah State,1979,N,N
11,9,0,2,Western Athletic,,UTEP,1979,N,N
11,10,0,1,SEC,,Vanderbilt,1979,N,N
11,6,0,5,FBS Independents,,Villanova,1979,N,N
11,5,0,6,ACC,,Virginia,1979,N,N
11,6,0,5,FBS Independents,,Virginia Tech,1979,N,N
11,5,0,6,Southern,,VMI,1979,N,N
12,4,0,8,ACC,,Wake Forest,1979,N,N
12,3,0,9,Pac-10,,Washington,1979,N,N
11,8,0,3,Pac-10,,Washington State,1979,N,N
11,5,0,6,Southern,,Western Carolina,1979,N,N
11,5,0,6,Mid-American,,Western Michigan,1979,N,N
11,5,0,6,Missouri Valley,,West Texas A&M,1979,N,N
11,6,0,5,FBS Independents,,West Virginia,1979,N,N
11,10,0,1,Missouri Valley,,Wichita State,1979,N,N
11,7,0,4,FBS Independents,,William & Mary,1979,N,N
11,7,0,4,Big Ten,,Wisconsin,1979,N,N
12,8,0,4,Western Athletic,,Wyoming,1979,N,N
9,1,0,8,Ivy,,Yale,1979,N,N
12,9,0,3,Western Athletic,,Air Force,1980,N,N
12,2,0,10,SEC,,Alabama,1980,N,N
11,4,0,7,Southern,,Appalachian State,1980,N,N
11,6,0,5,Pac-10,,Arizona,1980,N,N
11,4,0,7,Pac-10,,Arizona State,1980,N,N
12,5,0,7,Southwest,,Arkansas,1980,N,N
11,9,0,2,Southland,,Arkansas State,1980,N,N
11,8,0,3,FBS Independents,,Army,1980,N,N
11,6,0,5,SEC,,Auburn,1980,N,N
11,5,0,6,Mid-American,,Ball State,1980,N,N
12,2,0,10,Southwest,,Baylor,1980,N,N
11,4,0,7,FBS Independents,,Boston College,1980,N,N
11,7,0,4,Mid-American,,Bowling Green,1980,N,N
10,4,0,6,Ivy,,Brown,1980,N,N
13,1,0,12,Western Athletic,,BYU,1980,N,N
11,8,0,3,Pac-10,,California,1980,N,N
11,7,0,4,PCAA,,Cal State Fullerton,1980,N,N
11,2,0,9,Mid-American,,Central Michigan,1980,N,N
11,3,0,8,Southern,,Chattanooga,1980,N,N
11,9,0,2,FBS Independents,,Cincinnati,1980,N,N
11,5,0,6,ACC,,Clemson,1980,N,N
10,4,0,6,FBS Independents,,Colgate,1980,N,N
11,10,0,1,Big 8,,Colorado,1980,N,N
11,4,0,7,Western Athletic,,Colorado State,1980,N,N
10,9,0,1,Ivy,,Columbia,1980,N,N
10,5,0,5,Ivy,,Cornell,1980,N,N
10,6,0,4,Ivy,,Dartmouth,1980,N,N
11,3,0,8,Missouri Valley,,Drake,1980,N,N
11,9,0,2,ACC,,Duke,1980,N,N
11,7,0,4,FBS Independents,,East Carolina,1980,N,N
10,9,0,1,Mid-American,,Eastern Michigan,1980,N,N
11,9,0,2,Southern,,East Tennessee State,1980,N,N
12,4,0,8,SEC,,Florida,1980,N,N
12,2,0,10,FBS Independents,,Florida State,1980,N,N
11,6,0,5,PCAA,,Fresno State,1980,N,N
11,2,0,9,Southern,,Furman,1980,N,N
12,0,0,12,SEC,,Georgia,1980,Y,N
11,10,0,1,FBS Independents,,Georgia Tech,1980,N,N
10,3,0,7,Ivy,,Harvard,1980,N,N
11,3,0,8,Western Athletic,,Hawai'i,1980,N,N
11,8,0,3,FBS Independents,,Holy Cross,1980,N,N
12,5,0,7,Southwest,,Houston,1980,N,N
11,8,0,3,Big Ten,,Illinois,1980,N,N
11,7,0,4,FBS Independents,,Illinois State,1980,N,N
11,5,0,6,Big Ten,,Indiana,1980,N,N
11,5,0,6,Missouri Valley,,Indiana State,1980,N,N
11,7,0,4,Big Ten,,Iowa,1980,N,N
11,5,0,6,Big 8,,Iowa State,1980,N,N
11,5,0,6,Big 8,,Kansas,1980,N,N
11,8,0,3,Big 8,,Kansas State,1980,N,N
11,8,0,3,Mid-American,,Kent State,1980,N,N
11,8,0,3,SEC,,Kentucky,1980,N,N
11,8,0,3,Southland,,Lamar,1980,N,N
11,3,0,8,PCAA,,Long Beach State,1980,N,N
11,4,0,7,Southland,,Louisiana,1980,N,N
11,4,0,7,FBS Independents,,Louisiana Monroe,1980,N,N
11,6,0,5,Southland,,Louisiana Tech,1980,N,N
11,6,0,5,FBS Independents,,Louisville,1980,N,N
11,4,0,7,SEC,,LSU,1980,N,N
11,8,0,3,Southern,,Marshall,1980,N,N
12,4,0,8,ACC,,Maryland,1980,N,N
12,2,0,10,Southland,,McNeese,1980,N,N
11,9,0,2,FBS Independents,,Memphis,1980,N,N
12,3,0,9,FBS Independents,,Miami,1980,N,N
11,6,0,5,Mid-American,,Miami (OH),1980,N,N
12,2,0,10,Big Ten,,Michigan,1980,N,N
11,8,0,3,Big Ten,,Michigan State,1980,N,N
11,6,0,5,Big Ten,,Minnesota,1980,N,N
12,3,0,9,SEC,,Mississippi State,1980,N,N
12,4,0,8,Big 8,,Missouri,1980,N,N
12,4,0,8,FBS Independents,,Navy,1980,N,N
11,5,0,6,ACC,,NC State,1980,N,N
12,2,0,10,Big 8,,Nebraska,1980,N,N
11,7,0,4,Western Athletic,,New Mexico,1980,N,N
11,7,0,4,Missouri Valley,,New Mexico State,1980,N,N
12,1,0,11,ACC,,North Carolina,1980,N,N
11,4,0,7,Mid-American,,Northern Illinois,1980,N,N
11,5,0,6,FBS Independents,,North Texas,1980,N,N
11,11,0,0,Big Ten,,Northwestern,1980,N,N
12,2,0,10,FBS Independents,,Notre Dame,1980,N,N
11,5,0,6,Mid-American,,Ohio,1980,N,N
12,3,0,9,Big Ten,,Ohio State,1980,N,N
12,2,0,10,Big 8,,Oklahoma,1980,N,N
11,8,0,3,Big 8,,Oklahoma State,1980,N,N
11,8,0,3,SEC,,Ole Miss,1980,N,N
11,5,0,6,Pac-10,,Oregon,1980,N,N
11,11,0,0,Pac-10,,Oregon State,1980,N,N
12,8,0,4,PCAA,,Pacific,1980,N,N
12,2,0,10,FBS Independents,,Penn State,1980,N,N
10,9,0,1,Ivy,,Pennsylvania,1980,N,N
12,1,0,11,FBS Independents,,Pittsburgh,1980,N,N
10,4,0,6,Ivy,,Princeton,1980,N,N
12,3,0,9,Big Ten,,Purdue,1980,N,N
11,6,0,5,Southwest,,Rice,1980,N,N
11,6,0,5,FBS Independents,,Richmond,1980,N,N
11,4,0,7,FBS Independents,,Rutgers,1980,N,N
12,8,0,4,Western Athletic,,San Diego State,1980,N,N
11,4,0,7,PCAA,,San Josï¿½ State,1980,N,N
12,4,0,8,Southwest,,SMU,1980,N,N
12,4,0,8,FBS Independents,,South Carolina,1980,N,N
11,8,0,3,Missouri Valley,,Southern Illinois,1980,N,N
12,3,0,9,FBS Independents,,Southern Mississippi,1980,N,N
11,5,0,6,Pac-10,,Stanford,1980,N,N
11,6,0,5,FBS Independents,,Syracuse,1980,N,N
11,10,0,1,Southwest,,TCU,1980,N,N
11,7,0,4,FBS Independents,,Temple,1980,N,N
11,6,0,5,SEC,,Tennessee,1980,N,N
12,5,0,7,Southwest,,Texas,1980,N,N
11,7,0,4,Southwest,,Texas A&M,1980,N,N
11,8,0,3,Southland,,Texas-Arlington,1980,N,N
11,6,0,5,Southwest,,Texas Tech,1980,N,N
11,4,0,7,Southern,,The Citadel,1980,N,N
11,7,0,4,Mid-American,,Toledo,1980,N,N
12,5,0,7,FBS Independents,,Tulane,1980,N,N
11,3,0,8,Missouri Valley,,Tulsa,1980,N,N
11,2,0,9,Pac-10,,UCLA,1980,N,N
11,4,0,7,FBS Independents,,UNLV,1980,N,N
11,2,0,9,Pac-10,,USC,1980,N,N
11,6,0,5,Western Athletic,,Utah,1980,N,N
11,5,0,6,PCAA,,Utah State,1980,N,N
12,11,0,1,Western Athletic,,UTEP,1980,N,N
11,9,0,2,SEC,,Vanderbilt,1980,N,N
11,5,0,6,FBS Independents,,Villanova,1980,N,N
11,7,0,4,ACC,,Virginia,1980,N,N
12,4,0,8,FBS Independents,,Virginia Tech,1980,N,N
11,8,0,3,Southern,,VMI,1980,N,N
11,6,0,5,ACC,,Wake Forest,1980,N,N
12,3,0,9,Pac-10,,Washington,1980,N,N
11,7,0,4,Pac-10,,Washington State,1980,N,N
11,8,0,3,Southern,,Western Carolina,1980,N,N
11,4,0,7,Mid-American,,Western Michigan,1980,N,N
11,6,0,5,Missouri Valley,,West Texas A&M,1980,N,N
12,6,0,6,FBS Independents,,West Virginia,1980,N,N
11,6,0,5,Missouri Valley,,Wichita State,1980,N,N
11,9,0,2,FBS Independents,,William & Mary,1980,N,N
11,7,0,4,Big Ten,,Wisconsin,1980,N,N
11,5,0,6,Western Athletic,,Wyoming,1980,N,N
10,2,0,8,Ivy,,Yale,1980,N,N
11,7,0,4,Western Athletic,,Air Force,1981,N,N
12,3,0,9,SEC,,Alabama,1981,N,N
11,8,0,3,Southern,,Appalachian State,1981,N,N
11,5,0,6,Pac-10,,Arizona,1981,N,N
11,2,0,9,Pac-10,,Arizona State,1981,N,N
12,4,0,8,Southwest,,Arkansas,1981,N,N
11,5,0,6,Southland,,Arkansas State,1981,N,N
11,8,0,3,FBS Independents,,Army,1981,N,N
11,6,0,5,SEC,,Auburn,1981,N,N
11,7,0,4,Mid-American,,Ball State,1981,N,N
11,6,0,5,Southwest,,Baylor,1981,N,N
11,6,0,5,FBS Independents,,Boston College,1981,N,N
11,6,0,5,Mid-American,,Bowling Green,1981,N,N
10,7,0,3,Ivy,,Brown,1981,N,N
13,2,0,11,Western Athletic,,BYU,1981,N,N
11,9,0,2,Pac-10,,California,1981,N,N
11,8,0,3,PCAA,,Cal State Fullerton,1981,N,N
11,4,0,7,Mid-American,,Central Michigan,1981,N,N
11,4,0,7,Southern,,Chattanooga,1981,N,N
11,5,0,6,FBS Independents,,Cincinnati,1981,N,N
12,0,0,12,ACC,,Clemson,1981,Y,N
10,3,0,7,FBS Independents,,Colgate,1981,N,N
11,8,0,3,Big 8,,Colorado,1981,N,N
12,12,0,0,Western Athletic,,Colorado State,1981,N,N
10,9,0,1,Ivy,,Columbia,1981,N,N
10,7,0,3,Ivy,,Cornell,1981,N,N
10,4,0,6,Ivy,,Dartmouth,1981,N,N
11,1,0,10,Missouri Valley,,Drake,1981,N,N
11,5,0,6,ACC,,Duke,1981,N,N
11,6,0,5,FBS Independents,,East Carolina,1981,N,N
11,11,0,0,Mid-American,,Eastern Michigan,1981,N,N
11,5,0,6,Southern,,East Tennessee State,1981,N,N
12,5,0,7,SEC,,Florida,1981,N,N
11,5,0,6,FBS Independents,,Florida State,1981,N,N
11,6,0,5,PCAA,,Fresno State,1981,N,N
11,3,0,8,Southern,,Furman,1981,N,N
12,2,0,10,SEC,,Georgia,1981,N,N
11,10,0,1,FBS Independents,,Georgia Tech,1981,N,N
10,5,0,5,Ivy,,Harvard,1981,N,N
11,2,0,9,Western Athletic,,Hawai'i,1981,N,N
11,5,0,6,FBS Independents,,Holy Cross,1981,N,N
12,5,0,7,Southwest,,Houston,1981,N,N
11,4,0,7,Big Ten,,Illinois,1981,N,N
10,7,0,3,Missouri Valley,,Illinois State,1981,N,N
11,8,0,3,Big Ten,,Indiana,1981,N,N
11,6,0,5,Missouri Valley,,Indiana State,1981,N,N
12,4,0,8,Big Ten,,Iowa,1981,N,N
11,5,0,6,Big 8,,Iowa State,1981,N,N
12,4,0,8,Big 8,,Kansas,1981,N,N
11,9,0,2,Big 8,,Kansas State,1981,N,N
11,7,0,4,Mid-American,,Kent State,1981,N,N
11,8,0,3,SEC,,Kentucky,1981,N,N
11,7,0,4,Southland,,Lamar,1981,N,N
10,8,0,2,PCAA,,Long Beach State,1981,N,N
11,10,0,1,Southland,,Louisiana,1981,N,N
11,6,0,5,FBS Independents,,Louisiana Monroe,1981,N,N
11,6,0,5,Southland,,Louisiana Tech,1981,N,N
11,6,0,5,FBS Independents,,Louisville,1981,N,N
11,7,0,4,SEC,,LSU,1981,N,N
11,9,0,2,Southern,,Marshall,1981,N,N
11,7,0,4,ACC,,Maryland,1981,N,N
11,3,0,8,Southland,,McNeese,1981,N,N
11,10,0,1,FBS Independents,,Memphis,1981,N,N
11,2,0,9,FBS Independents,,Miami,1981,N,N
11,2,0,9,Mid-American,,Miami (OH),1981,N,N
12,3,0,9,Big Ten,,Michigan,1981,N,N
11,6,0,5,Big Ten,,Michigan State,1981,N,N
11,5,0,6,Big Ten,,Minnesota,1981,N,N
12,4,0,8,SEC,,Mississippi State,1981,N,N
12,4,0,8,Big 8,,Missouri,1981,N,N
12,4,0,8,FBS Independents,,Navy,1981,N,N
11,7,0,4,ACC,,NC State,1981,N,N
12,3,0,9,Big 8,,Nebraska,1981,N,N
12,8,0,4,Western Athletic,,New Mexico,1981,N,N
11,8,0,3,Missouri Valley,,New Mexico State,1981,N,N
12,2,0,10,ACC,,North Carolina,1981,N,N
11,8,0,3,Mid-American,,Northern Illinois,1981,N,N
11,9,0,2,FBS Independents,,North Texas,1981,N,N
11,11,0,0,Big Ten,,Northwestern,1981,N,N
11,6,0,5,FBS Independents,,Notre Dame,1981,N,N
11,6,0,5,Mid-American,,Ohio,1981,N,N
12,3,0,9,Big Ten,,Ohio State,1981,N,N
12,5,0,7,Big 8,,Oklahoma,1981,N,N
12,5,0,7,Big 8,,Oklahoma State,1981,N,N
11,7,0,4,SEC,,Ole Miss,1981,N,N
11,9,0,2,Pac-10,,Oregon,1981,N,N
11,10,0,1,Pac-10,,Oregon State,1981,N,N
11,6,0,5,PCAA,,Pacific,1981,N,N
12,2,0,10,FBS Independents,,Penn State,1981,N,N
10,9,0,1,Ivy,,Pennsylvania,1981,N,N
12,1,0,11,FBS Independents,,Pittsburgh,1981,N,N
10,4,0,6,Ivy,,Princeton,1981,N,N
11,6,0,5,Big Ten,,Purdue,1981,N,N
11,7,0,4,Southwest,,Rice,1981,N,N
11,7,0,4,FBS Independents,,Richmond,1981,N,N
11,6,0,5,FBS Independents,,Rutgers,1981,N,N
11,5,0,6,Western Athletic,,San Diego State,1981,N,N
12,3,0,9,PCAA,,San Josï¿½ State,1981,N,N
11,1,0,10,Southwest,,SMU,1981,N,N
12,6,0,6,FBS Independents,,South Carolina,1981,N,N
11,4,0,7,Missouri Valley,,Southern Illinois,1981,N,N
12,2,0,10,FBS Independents,,Southern Mississippi,1981,N,N
11,7,0,4,Pac-10,,Stanford,1981,N,N
11,6,0,5,FBS Independents,,Syracuse,1981,N,N
11,8,0,3,Southwest,,TCU,1981,N,N
10,5,0,5,FBS Independents,,Temple,1981,N,N
12,4,0,8,SEC,,Tennessee,1981,N,N
12,1,0,11,Southwest,,Texas,1981,N,N
12,5,0,7,Southwest,,Texas A&M,1981,N,N
11,5,0,6,Southland,,Texas-Arlington,1981,N,N
11,10,0,1,Southwest,,Texas Tech,1981,N,N
11,3,0,8,Southern,,The Citadel,1981,N,N
12,3,0,9,Mid-American,,Toledo,1981,N,N
11,5,0,6,FBS Independents,,Tulane,1981,N,N
11,5,0,6,Missouri Valley,,Tulsa,1981,N,N
12,4,0,8,Pac-10,,UCLA,1981,N,N
12,6,0,6,FBS Independents,,UNLV,1981,N,N
12,3,0,9,Pac-10,,USC,1981,N,N
11,2,0,9,Western Athletic,,Utah,1981,N,N
11,5,0,6,PCAA,,Utah State,1981,N,N
11,10,0,1,Western Athletic,,UTEP,1981,N,N
11,7,0,4,SEC,,Vanderbilt,1981,N,N
11,10,0,1,ACC,,Virginia,1981,N,N
11,4,0,7,FBS Independents,,Virginia Tech,1981,N,N
10,3,0,7,Southern,,VMI,1981,N,N
11,7,0,4,ACC,,Wake Forest,1981,N,N
12,2,0,10,Pac-10,,Washington,1981,N,N
12,4,0,8,Pac-10,,Washington State,1981,N,N
11,7,0,4,Southern,,Western Carolina,1981,N,N
11,5,0,6,Mid-American,,Western Michigan,1981,N,N
11,4,0,7,Missouri Valley,,West Texas A&M,1981,N,N
12,3,0,9,FBS Independents,,West Virginia,1981,N,N
11,6,0,5,Missouri Valley,,Wichita State,1981,N,N
11,6,0,5,FBS Independents,,William & Mary,1981,N,N
12,5,0,7,Big Ten,,Wisconsin,1981,N,N
11,3,0,8,Western Athletic,,Wyoming,1981,N,N
10,1,0,9,Ivy,,Yale,1981,N,N
13,5,0,8,Western Athletic,,Air Force,1982,N,N
12,4,0,8,SEC,,Alabama,1982,N,N
11,4,0,7,Pac-10,,Arizona,1982,N,N
12,2,0,10,Pac-10,,Arizona State,1982,N,N
12,2,0,10,Southwest,,Arkansas,1982,N,N
11,7,0,4,FBS Independents,,Army,1982,N,N
12,3,0,9,SEC,,Auburn,1982,N,N
11,6,0,5,Mid-American,,Ball State,1982,N,N
11,7,0,4,Southwest,,Baylor,1982,N,N
12,3,0,9,FBS Independents,,Boston College,1982,N,N
12,5,0,7,Mid-American,,Bowling Green,1982,N,N
12,4,0,8,Western Athletic,,BYU,1982,N,N
11,4,0,7,Pac-10,,California,1982,N,N
12,9,0,3,PCAA,,Cal State Fullerton,1982,N,N
11,5,0,6,Mid-American,,Central Michigan,1982,N,N
11,5,0,6,FBS Independents,,Cincinnati,1982,N,N
11,2,0,9,ACC,,Clemson,1982,N,N
11,8,0,3,Big 8,,Colorado,1982,N,N
11,7,0,4,Western Athletic,,Colorado State,1982,N,N
11,7,0,4,Missouri Valley,,Drake,1982,N,N
11,5,0,6,ACC,,Duke,1982,N,N
11,4,0,7,FBS Independents,,East Carolina,1982,N,N
11,10,0,1,Mid-American,,Eastern Michigan,1982,N,N
12,4,0,8,SEC,,Florida,1982,N,N
12,3,0,9,FBS Independents,,Florida State,1982,N,N
12,1,0,11,PCAA,,Fresno State,1982,N,N
12,1,0,11,SEC,,Georgia,1982,N,N
11,5,0,6,FBS Independents,,Georgia Tech,1982,N,N
11,5,0,6,Western Athletic,,Hawai'i,1982,N,N
11,5,0,6,Southwest,,Houston,1982,N,N
12,5,0,7,Big Ten,,Illinois,1982,N,N
11,9,0,2,Missouri Valley,,Illinois State,1982,N,N
11,6,0,5,Big Ten,,Indiana,1982,N,N
11,6,0,5,Missouri Valley,,Indiana State,1982,N,N
12,4,0,8,Big Ten,,Iowa,1982,N,N
11,6,0,5,Big 8,,Iowa State,1982,N,N
11,7,0,4,Big 8,,Kansas,1982,N,N
12,6,0,6,Big 8,,Kansas State,1982,N,N
11,11,0,0,Mid-American,,Kent State,1982,N,N
11,11,0,0,SEC,,Kentucky,1982,N,N
11,5,0,6,PCAA,,Long Beach State,1982,N,N
11,3,0,8,FBS Independents,,Louisiana,1982,N,N
11,6,0,5,FBS Independents,,Louisville,1982,N,N
12,4,0,8,SEC,,LSU,1982,N,N
12,4,0,8,ACC,,Maryland,1982,N,N
11,10,0,1,FBS Independents,,Memphis,1982,N,N
11,4,0,7,FBS Independents,,Miami,1982,N,N
11,4,0,7,Mid-American,,Miami (OH),1982,N,N
12,4,0,8,Big Ten,,Michigan,1982,N,N
11,9,0,2,Big Ten,,Michigan State,1982,N,N
11,8,0,3,Big Ten,,Minnesota,1982,N,N
11,6,0,5,SEC,,Mississippi State,1982,N,N
11,5,0,6,Big 8,,Missouri,1982,N,N
11,5,0,6,FBS Independents,,Navy,1982,N,N
11,5,0,6,ACC,,NC State,1982,N,N
13,1,0,12,Big 8,,Nebraska,1982,N,N
11,1,0,10,Western Athletic,,New Mexico,1982,N,N
11,8,0,3,Missouri Valley,,New Mexico State,1982,N,N
12,4,0,8,ACC,,North Carolina,1982,N,N
10,5,0,5,Mid-American,,Northern Illinois,1982,N,N
11,9,0,2,FBS Independents,,North Texas,1982,N,N
11,8,0,3,Big Ten,,Northwestern,1982,N,N
11,4,0,7,FBS Independents,,Notre Dame,1982,N,N
11,5,0,6,Mid-American,,Ohio,1982,N,N
12,3,0,9,Big Ten,,Ohio State,1982,N,N
12,4,0,8,Big 8,,Oklahoma,1982,N,N
11,7,0,4,Big 8,,Oklahoma State,1982,N,N
11,7,0,4,SEC,,Ole Miss,1982,N,N
11,9,0,2,Pac-10,,Oregon,1982,N,N
11,9,0,2,Pac-10,,Oregon State,1982,N,N
11,9,0,2,PCAA,,Pacific,1982,N,N
12,1,0,11,FBS Independents,,Penn State,1982,Y,N
12,3,0,9,FBS Independents,,Pittsburgh,1982,N,N
11,8,0,3,Big Ten,,Purdue,1982,N,N
11,11,0,0,Southwest,,Rice,1982,N,N
10,10,0,0,FBS Independents,,Richmond,1982,N,N
11,6,0,5,FBS Independents,,Rutgers,1982,N,N
12,5,0,7,Western Athletic,,San Diego State,1982,N,N
11,3,0,8,PCAA,,San Josï¿½ State,1982,N,N
12,1,0,11,Southwest,,SMU,1982,N,N
11,7,0,4,FBS Independents,,South Carolina,1982,N,N
11,5,0,6,Missouri Valley,,Southern Illinois,1982,N,N
11,4,0,7,FBS Independents,,Southern Mississippi,1982,N,N
11,6,0,5,Pac-10,,Stanford,1982,N,N
11,9,0,2,FBS Independents,,Syracuse,1982,N,N
11,8,0,3,Southwest,,TCU,1982,N,N
11,7,0,4,FBS Independents,,Temple,1982,N,N
12,5,0,7,SEC,,Tennessee,1982,N,N
12,3,0,9,Southwest,,Texas,1982,N,N
11,6,0,5,Southwest,,Texas A&M,1982,N,N
11,7,0,4,Southwest,,Texas Tech,1982,N,N
11,5,0,6,Mid-American,,Toledo,1982,N,N
11,7,0,4,FBS Independents,,Tulane,1982,N,N
11,1,0,10,Missouri Valley,,Tulsa,1982,N,N
12,2,0,10,Pac-10,,UCLA,1982,N,N
11,8,0,3,PCAA,,UNLV,1982,N,N
11,3,0,8,Pac-10,,USC,1982,N,N
11,6,0,5,Western Athletic,,Utah,1982,N,N
11,6,0,5,PCAA,,Utah State,1982,N,N
12,10,0,2,Western Athletic,,UTEP,1982,N,N
12,4,0,8,SEC,,Vanderbilt,1982,N,N
11,9,0,2,ACC,,Virginia,1982,N,N
11,4,0,7,FBS Independents,,Virginia Tech,1982,N,N
11,8,0,3,ACC,,Wake Forest,1982,N,N
12,2,0,10,Pac-10,,Washington,1982,N,N
11,8,0,3,Pac-10,,Washington State,1982,N,N
11,2,0,9,Mid-American,,Western Michigan,1982,N,N
11,8,0,3,Missouri Valley,,West Texas A&M,1982,N,N
12,3,0,9,FBS Independents,,West Virginia,1982,N,N
11,3,0,8,Missouri Valley,,Wichita State,1982,N,N
11,8,0,3,FBS Independents,,William & Mary,1982,N,N
12,5,0,7,Big Ten,,Wisconsin,1982,N,N
12,7,0,5,Western Athletic,,Wyoming,1982,N,N
12,2,0,10,Western Athletic,,Air Force,1983,N,N
12,4,0,8,SEC,,Alabama,1983,N,N
11,3,0,8,Pac-10,,Arizona,1983,N,N
11,4,0,7,Pac-10,,Arizona State,1983,N,N
11,5,0,6,Southwest,,Arkansas,1983,N,N
11,9,0,2,FBS Independents,,Army,1983,N,N
12,1,0,11,SEC,,Auburn,1983,N,N
11,5,0,6,Mid-American,,Ball State,1983,N,N
12,5,0,7,Southwest,,Baylor,1983,N,N
12,3,0,9,FBS Independents,,Boston College,1983,N,N
11,3,0,8,Mid-American,,Bowling Green,1983,N,N
12,1,0,11,Western Athletic,,BYU,1983,N,N
11,6,0,5,Pac-10,,California,1983,N,N
12,5,0,7,PCAA,,Cal State Fullerton,1983,N,N
11,3,0,8,Mid-American,,Central Michigan,1983,N,N
11,6,0,5,FBS Independents,,Cincinnati,1983,N,N
11,2,0,9,ACC,,Clemson,1983,N,N
11,7,0,4,Big 8,,Colorado,1983,N,N
12,7,0,5,Western Athletic,,Colorado State,1983,N,N
11,10,0,1,Missouri Valley,,Drake,1983,N,N
11,8,0,3,ACC,,Duke,1983,N,N
11,3,0,8,FBS Independents,,East Carolina,1983,N,N
11,10,0,1,Mid-American,,Eastern Michigan,1983,N,N
12,2,0,10,SEC,,Florida,1983,N,N
12,5,0,7,FBS Independents,,Florida State,1983,N,N
11,5,0,6,PCAA,,Fresno State,1983,N,N
12,1,0,11,SEC,,Georgia,1983,N,N
11,8,0,3,ACC,,Georgia Tech,1983,N,N
11,6,0,5,Western Athletic,,Hawai'i,1983,N,N
11,7,0,4,Southwest,,Houston,1983,N,N
12,2,0,10,Big Ten,,Illinois,1983,N,N
11,4,0,7,Missouri Valley,,Illinois State,1983,N,N
11,8,0,3,Big Ten,,Indiana,1983,N,N
13,4,0,9,Missouri Valley,,Indiana State,1983,N,N
12,3,0,9,Big Ten,,Iowa,1983,N,N
11,7,0,4,Big 8,,Iowa State,1983,N,N
11,6,0,5,Big 8,,Kansas,1983,N,N
11,8,0,3,Big 8,,Kansas State,1983,N,N
11,10,0,1,Mid-American,,Kent State,1983,N,N
12,6,0,6,SEC,,Kentucky,1983,N,N
12,4,0,8,PCAA,,Long Beach State,1983,N,N
10,6,0,4,FBS Independents,,Louisiana,1983,N,N
11,8,0,3,FBS Independents,,Louisville,1983,N,N
11,7,0,4,SEC,,LSU,1983,N,N
12,4,0,8,ACC,,Maryland,1983,N,N
11,5,0,6,FBS Independents,,Memphis,1983,N,N
12,1,0,11,FBS Independents,,Miami,1983,Y,N
11,7,0,4,Mid-American,,Miami (OH),1983,N,N
12,3,0,9,Big Ten,,Michigan,1983,N,N
11,6,0,5,Big Ten,,Michigan State,1983,N,N
11,10,0,1,Big Ten,,Minnesota,1983,N,N
11,8,0,3,SEC,,Mississippi State,1983,N,N
12,5,0,7,Big 8,,Missouri,1983,N,N
11,8,0,3,FBS Independents,,Navy,1983,N,N
11,8,0,3,ACC,,NC State,1983,N,N
13,1,0,12,Big 8,,Nebraska,1983,N,N
12,6,0,6,Western Athletic,,New Mexico,1983,N,N
11,6,0,5,Missouri Valley,,New Mexico State,1983,N,N
12,4,0,8,ACC,,North Carolina,1983,N,N
12,2,0,10,Mid-American,,Northern Illinois,1983,N,N
11,9,0,2,Big Ten,,Northwestern,1983,N,N
12,5,0,7,FBS Independents,,Notre Dame,1983,N,N
11,7,0,4,Mid-American,,Ohio,1983,N,N
12,3,0,9,Big Ten,,Ohio State,1983,N,N
12,4,0,8,Big 8,,Oklahoma,1983,N,N
12,4,0,8,Big 8,,Oklahoma State,1983,N,N
12,6,0,6,SEC,,Ole Miss,1983,N,N
11,7,0,4,Pac-10,,Oregon,1983,N,N
11,8,0,3,Pac-10,,Oregon State,1983,N,N
12,9,0,3,PCAA,,Pacific,1983,N,N
13,4,0,9,FBS Independents,,Penn State,1983,N,N
12,4,0,8,FBS Independents,,Pittsburgh,1983,N,N
11,8,0,3,Big Ten,,Purdue,1983,N,N
11,10,0,1,Southwest,,Rice,1983,N,N
11,8,0,3,FBS Independents,,Richmond,1983,N,N
11,8,0,3,FBS Independents,,Rutgers,1983,N,N
12,9,0,3,Western Athletic,,San Diego State,1983,N,N
11,6,0,5,PCAA,,San Josï¿½ State,1983,N,N
12,2,0,10,Southwest,,SMU,1983,N,N
11,6,0,5,FBS Independents,,South Carolina,1983,N,N
14,1,0,13,Missouri Valley,,Southern Illinois,1983,N,N
11,4,0,7,FBS Independents,,Southern Mississippi,1983,N,N
11,10,0,1,Pac-10,,Stanford,1983,N,N
11,5,0,6,FBS Independents,,Syracuse,1983,N,N
11,9,0,2,Southwest,,TCU,1983,N,N
11,7,0,4,FBS Independents,,Temple,1983,N,N
12,3,0,9,SEC,,Tennessee,1983,N,N
12,1,0,11,Southwest,,Texas,1983,N,N
11,5,0,6,Southwest,,Texas A&M,1983,N,N
11,8,0,3,Southwest,,Texas Tech,1983,N,N
11,2,0,9,Mid-American,,Toledo,1983,N,N
11,7,0,4,FBS Independents,,Tulane,1983,N,N
11,3,0,8,Missouri Valley,,Tulsa,1983,N,N
12,5,0,7,Pac-10,,UCLA,1983,N,N
11,4,0,7,PCAA,,UNLV,1983,N,N
11,7,0,4,Pac-10,,USC,1983,N,N
11,6,0,5,Western Athletic,,Utah,1983,N,N
11,6,0,5,PCAA,,Utah State,1983,N,N
12,10,0,2,Western Athletic,,UTEP,1983,N,N
11,9,0,2,SEC,,Vanderbilt,1983,N,N
11,5,0,6,ACC,,Virginia,1983,N,N
11,2,0,9,FBS Independents,,Virginia Tech,1983,N,N
11,7,0,4,ACC,,Wake Forest,1983,N,N
12,4,0,8,Pac-10,,Washington,1983,N,N
11,4,0,7,Pac-10,,Washington State,1983,N,N
11,5,0,6,Mid-American,,Western Michigan,1983,N,N
11,11,0,0,Missouri Valley,,West Texas A&M,1983,N,N
12,3,0,9,FBS Independents,,West Virginia,1983,N,N
11,8,0,3,Missouri Valley,,Wichita State,1983,N,N
11,5,0,6,FBS Independents,,William & Mary,1983,N,N
11,4,0,7,Big Ten,,Wisconsin,1983,N,N
12,5,0,7,Western Athletic,,Wyoming,1983,N,N
12,4,0,8,Western Athletic,,Air Force,1984,N,N
11,6,0,5,SEC,,Alabama,1984,N,N
11,4,0,7,Pac-10,,Arizona,1984,N,N
11,6,0,5,Pac-10,,Arizona State,1984,N,N
12,5,0,7,Southwest,,Arkansas,1984,N,N
12,3,0,9,FBS Independents,,Army,1984,N,N
13,4,0,9,SEC,,Auburn,1984,N,N
11,8,0,3,Mid-American,,Ball State,1984,N,N
11,6,0,5,Southwest,,Baylor,1984,N,N
12,2,0,10,FBS Independents,,Boston College,1984,N,N
11,3,0,8,Mid-American,,Bowling Green,1984,N,N
13,0,0,13,Western Athletic,,BYU,1984,Y,N
11,9,0,2,Pac-10,,California,1984,N,N
12,1,0,11,PCAA,,Cal State Fullerton,1984,N,N
11,2,0,9,Mid-American,,Central Michigan,1984,N,N
11,9,0,2,FBS Independents,,Cincinnati,1984,N,N
11,4,0,7,ACC,,Clemson,1984,N,N
11,10,0,1,Big 8,,Colorado,1984,N,N
11,8,0,3,Western Athletic,,Colorado State,1984,N,N
11,7,0,4,Missouri Valley,,Drake,1984,N,N
11,9,0,2,ACC,,Duke,1984,N,N
11,9,0,2,FBS Independents,,East Carolina,1984,N,N
11,8,0,3,Mid-American,,Eastern Michigan,1984,N,N
11,2,0,9,SEC,,Florida,1984,N,N
12,4,0,8,FBS Independents,,Florida State,1984,N,N
12,6,0,6,PCAA,,Fresno State,1984,N,N
12,4,0,8,SEC,,Georgia,1984,N,N
11,4,0,7,ACC,,Georgia Tech,1984,N,N
11,4,0,7,Western Athletic,,Hawai'i,1984,N,N
12,5,0,7,Southwest,,Houston,1984,N,N
11,4,0,7,Big Ten,,Illinois,1984,N,N
11,6,0,5,Missouri Valley,,Illinois State,1984,N,N
11,11,0,0,Big Ten,,Indiana,1984,N,N
12,3,0,9,Missouri Valley,,Indiana State,1984,N,N
13,5,0,8,Big Ten,,Iowa,1984,N,N
11,8,0,3,Big 8,,Iowa State,1984,N,N
11,6,0,5,Big 8,,Kansas,1984,N,N
11,7,0,4,Big 8,,Kansas State,1984,N,N
11,7,0,4,Mid-American,,Kent State,1984,N,N
12,3,0,9,SEC,,Kentucky,1984,N,N
11,7,0,4,PCAA,,Long Beach State,1984,N,N
11,5,0,6,FBS Independents,,Louisiana,1984,N,N
11,9,0,2,FBS Independents,,Louisville,1984,N,N
12,3,0,9,SEC,,LSU,1984,N,N
12,3,0,9,ACC,,Maryland,1984,N,N
11,6,0,5,FBS Independents,,Memphis,1984,N,N
13,5,0,8,FBS Independents,,Miami,1984,N,N
11,7,0,4,Mid-American,,Miami (OH),1984,N,N
12,6,0,6,Big Ten,,Michigan,1984,N,N
12,6,0,6,Big Ten,,Michigan State,1984,N,N
11,7,0,4,Big Ten,,Minnesota,1984,N,N
11,7,0,4,SEC,,Mississippi State,1984,N,N
11,8,0,3,Big 8,,Missouri,1984,N,N
11,6,0,5,FBS Independents,,Navy,1984,N,N
11,8,0,3,ACC,,NC State,1984,N,N
12,2,0,10,Big 8,,Nebraska,1984,N,N
12,8,0,4,Western Athletic,,New Mexico,1984,N,N
11,9,0,2,PCAA,,New Mexico State,1984,N,N
11,6,0,5,ACC,,North Carolina,1984,N,N
11,7,0,4,Mid-American,,Northern Illinois,1984,N,N
11,9,0,2,Big Ten,,Northwestern,1984,N,N
12,5,0,7,FBS Independents,,Notre Dame,1984,N,N
11,7,0,4,Mid-American,,Ohio,1984,N,N
12,3,0,9,Big Ten,,Ohio State,1984,N,N
12,3,0,9,Big 8,,Oklahoma,1984,N,N
12,2,0,10,Big 8,,Oklahoma State,1984,N,N
11,6,0,5,SEC,,Ole Miss,1984,N,N
11,5,0,6,Pac-10,,Oregon,1984,N,N
11,9,0,2,Pac-10,,Oregon State,1984,N,N
11,7,0,4,PCAA,,Pacific,1984,N,N
11,5,0,6,FBS Independents,,Penn State,1984,N,N
11,8,0,3,FBS Independents,,Pittsburgh,1984,N,N
12,5,0,7,Big Ten,,Purdue,1984,N,N
11,10,0,1,Southwest,,Rice,1984,N,N
10,3,0,7,FBS Independents,,Rutgers,1984,N,N
12,8,0,4,Western Athletic,,San Diego State,1984,N,N
11,5,0,6,PCAA,,San Josï¿½ State,1984,N,N
12,2,0,10,Southwest,,SMU,1984,N,N
12,2,0,10,FBS Independents,,South Carolina,1984,N,N
11,8,0,3,Missouri Valley,,Southern Illinois,1984,N,N
11,7,0,4,FBS Independents,,Southern Mississippi,1984,N,N
11,6,0,5,Pac-10,,Stanford,1984,N,N
11,5,0,6,FBS Independents,,Syracuse,1984,N,N
12,4,0,8,Southwest,,TCU,1984,N,N
11,5,0,6,FBS Independents,,Temple,1984,N,N
12,5,0,7,SEC,,Tennessee,1984,N,N
12,4,0,8,Southwest,,Texas,1984,N,N
11,5,0,6,Southwest,,Texas A&M,1984,N,N
11,7,0,4,Southwest,,Texas Tech,1984,N,N
12,3,0,9,Mid-American,,Toledo,1984,N,N
11,8,0,3,FBS Independents,,Tulane,1984,N,N
11,5,0,6,Missouri Valley,,Tulsa,1984,N,N
12,3,0,9,Pac-10,,UCLA,1984,N,N
13,2,0,11,PCAA,,UNLV,1984,N,N
12,3,0,9,Pac-10,,USC,1984,N,N
12,5,0,7,Western Athletic,,Utah,1984,N,N
11,10,0,1,PCAA,,Utah State,1984,N,N
11,9,0,2,Western Athletic,,UTEP,1984,N,N
11,6,0,5,SEC,,Vanderbilt,1984,N,N
12,3,0,9,ACC,,Virginia,1984,N,N
12,4,0,8,FBS Independents,,Virginia Tech,1984,N,N
11,5,0,6,ACC,,Wake Forest,1984,N,N
12,1,0,11,Pac-10,,Washington,1984,N,N
11,5,0,6,Pac-10,,Washington State,1984,N,N
11,6,0,5,Mid-American,,Western Michigan,1984,N,N
11,8,0,3,Missouri Valley,,West Texas A&M,1984,N,N
12,4,0,8,FBS Independents,,West Virginia,1984,N,N
11,9,0,2,Missouri Valley,,Wichita State,1984,N,N
12,4,0,8,Big Ten,,Wisconsin,1984,N,N
12,6,0,6,Western Athletic,,Wyoming,1984,N,N
13,1,0,12,Western Athletic,,Air Force,1985,N,N
12,2,0,10,SEC,,Alabama,1985,N,N
12,4,0,8,Pac-10,,Arizona,1985,N,N
12,4,0,8,Pac-10,,Arizona State,1985,N,N
12,2,0,10,Southwest,,Arkansas,1985,N,N
12,3,0,9,FBS Independents,,Army,1985,N,N
12,4,0,8,SEC,,Auburn,1985,N,N
11,7,0,4,Mid-American,,Ball State,1985,N,N
12,3,0,9,Southwest,,Baylor,1985,N,N
12,8,0,4,FBS Independents,,Boston College,1985,N,N
12,1,0,11,Mid-American,,Bowling Green,1985,N,N
14,3,0,11,Western Athletic,,BYU,1985,N,N
11,7,0,4,Pac-10,,California,1985,N,N
11,5,0,6,PCAA,,Cal State Fullerton,1985,N,N
10,3,0,7,Mid-American,,Central Michigan,1985,N,N
11,6,0,5,FBS Independents,,Cincinnati,1985,N,N
12,6,0,6,ACC,,Clemson,1985,N,N
12,5,0,7,Big 8,,Colorado,1985,N,N
12,7,0,5,Western Athletic,,Colorado State,1985,N,N
11,7,0,4,Missouri Valley,,Drake,1985,N,N
11,7,0,4,ACC,,Duke,1985,N,N
11,9,0,2,FBS Independents,,East Carolina,1985,N,N
11,7,0,4,Mid-American,,Eastern Michigan,1985,N,N
11,2,0,9,SEC,,Florida,1985,N,N
12,3,0,9,FBS Independents,,Florida State,1985,N,N
12,1,0,11,PCAA,,Fresno State,1985,N,N
12,3,0,9,SEC,,Georgia,1985,N,N
12,2,0,10,ACC,,Georgia Tech,1985,N,N
12,7,0,5,Western Athletic,,Hawai'i,1985,N,N
11,7,0,4,Southwest,,Houston,1985,N,N
12,6,0,6,Big Ten,,Illinois,1985,N,N
11,4,0,7,Missouri Valley,,Illinois State,1985,N,N
11,7,0,4,Big Ten,,Indiana,1985,N,N
10,6,0,4,Missouri Valley,,Indiana State,1985,N,N
12,2,0,10,Big Ten,,Iowa,1985,N,N
11,6,0,5,Big 8,,Iowa State,1985,N,N
12,6,0,6,Big 8,,Kansas,1985,N,N
11,10,0,1,Big 8,,Kansas State,1985,N,N
11,8,0,3,Mid-American,,Kent State,1985,N,N
11,6,0,5,SEC,,Kentucky,1985,N,N
12,6,0,6,PCAA,,Long Beach State,1985,N,N
11,7,0,4,FBS Independents,,Louisiana,1985,N,N
11,9,0,2,FBS Independents,,Louisville,1985,N,N
12,3,0,9,SEC,,LSU,1985,N,N
12,3,0,9,ACC,,Maryland,1985,N,N
11,9,0,2,FBS Independents,,Memphis,1985,N,N
12,2,0,10,FBS Independents,,Miami,1985,N,N
11,3,0,8,Mid-American,,Miami (OH),1985,N,N
12,1,0,11,Big Ten,,Michigan,1985,N,N
12,5,0,7,Big Ten,,Michigan State,1985,N,N
12,5,0,7,Big Ten,,Minnesota,1985,N,N
11,6,0,5,SEC,,Mississippi State,1985,N,N
11,10,0,1,Big 8,,Missouri,1985,N,N
11,7,0,4,FBS Independents,,Navy,1985,N,N
11,8,0,3,ACC,,NC State,1985,N,N
12,3,0,9,Big 8,,Nebraska,1985,N,N
11,8,0,3,Western Athletic,,New Mexico,1985,N,N
11,10,0,1,PCAA,,New Mexico State,1985,N,N
11,6,0,5,ACC,,North Carolina,1985,N,N
11,7,0,4,Mid-American,,Northern Illinois,1985,N,N
11,8,0,3,Big Ten,,Northwestern,1985,N,N
11,6,0,5,FBS Independents,,Notre Dame,1985,N,N
11,9,0,2,Mid-American,,Ohio,1985,N,N
12,3,0,9,Big Ten,,Ohio State,1985,N,N
12,1,0,11,Big 8,,Oklahoma,1985,Y,N
12,4,0,8,Big 8,,Oklahoma State,1985,N,N
11,6,0,5,SEC,,Ole Miss,1985,N,N
11,6,0,5,Pac-10,,Oregon,1985,N,N
11,8,0,3,Pac-10,,Oregon State,1985,N,N
12,7,0,5,PCAA,,Pacific,1985,N,N
12,1,0,11,FBS Independents,,Penn State,1985,N,N
11,5,0,6,FBS Independents,,Pittsburgh,1985,N,N
11,6,0,5,Big Ten,,Purdue,1985,N,N
11,8,0,3,Southwest,,Rice,1985,N,N
11,8,0,3,FBS Independents,,Rutgers,1985,N,N
12,6,0,6,Western Athletic,,San Diego State,1985,N,N
11,9,0,2,PCAA,,San Josï¿½ State,1985,N,N
11,5,0,6,Southwest,,SMU,1985,N,N
11,6,0,5,FBS Independents,,South Carolina,1985,N,N
11,7,0,4,Missouri Valley,,Southern Illinois,1985,N,N
11,4,0,7,FBS Independents,,Southern Mississippi,1985,N,N
11,7,0,4,Pac-10,,Stanford,1985,N,N
12,5,0,7,FBS Independents,,Syracuse,1985,N,N
11,8,0,3,Southwest,,TCU,1985,N,N
11,7,0,4,FBS Independents,,Temple,1985,N,N
12,3,0,9,SEC,,Tennessee,1985,N,N
12,4,0,8,Southwest,,Texas,1985,N,N
12,2,0,10,Southwest,,Texas A&M,1985,N,N
11,7,0,4,Southwest,,Texas Tech,1985,N,N
11,7,0,4,Mid-American,,Toledo,1985,N,N
11,10,0,1,FBS Independents,,Tulane,1985,N,N
11,5,0,6,Missouri Valley,,Tulsa,1985,N,N
12,2,0,10,Pac-10,,UCLA,1985,N,N
11,5,0,6,PCAA,,UNLV,1985,N,N
12,6,0,6,Pac-10,,USC,1985,N,N
12,4,0,8,Western Athletic,,Utah,1985,N,N
11,8,0,3,PCAA,,Utah State,1985,N,N
11,10,0,1,Western Athletic,,UTEP,1985,N,N
11,8,0,3,SEC,,Vanderbilt,1985,N,N
11,5,0,6,ACC,,Virginia,1985,N,N
11,5,0,6,FBS Independents,,Virginia Tech,1985,N,N
11,7,0,4,ACC,,Wake Forest,1985,N,N
12,5,0,7,Pac-10,,Washington,1985,N,N
11,7,0,4,Pac-10,,Washington State,1985,N,N
11,6,0,5,Mid-American,,Western Michigan,1985,N,N
10,3,0,7,Missouri Valley,,West Texas A&M,1985,N,N
11,4,0,7,FBS Independents,,West Virginia,1985,N,N
11,8,0,3,Missouri Valley,,Wichita State,1985,N,N
11,6,0,5,Big Ten,,Wisconsin,1985,N,N
11,8,0,3,Western Athletic,,Wyoming,1985,N,N
11,5,0,6,Western Athletic,,Air Force,1986,N,N
13,3,0,10,SEC,,Alabama,1986,N,N
12,3,0,9,Pac-10,,Arizona,1986,N,N
12,2,0,10,Pac-10,,Arizona State,1986,N,N
12,3,0,9,Southwest,,Arkansas,1986,N,N
11,5,0,6,FBS Independents,,Army,1986,N,N
12,2,0,10,SEC,,Auburn,1986,N,N
11,5,0,6,Mid-American,,Ball State,1986,N,N
12,3,0,9,Southwest,,Baylor,1986,N,N
12,3,0,9,FBS Independents,,Boston College,1986,N,N
11,6,0,5,Mid-American,,Bowling Green,1986,N,N
13,5,0,8,Western Athletic,,BYU,1986,N,N
11,9,0,2,Pac-10,,California,1986,N,N
12,9,0,3,PCAA,,Cal State Fullerton,1986,N,N
10,5,0,5,Mid-American,,Central Michigan,1986,N,N
11,6,0,5,FBS Independents,,Cincinnati,1986,N,N
12,3,0,9,ACC,,Clemson,1986,N,N
12,6,0,6,Big 8,,Colorado,1986,N,N
11,5,0,6,Western Athletic,,Colorado State,1986,N,N
11,7,0,4,ACC,,Duke,1986,N,N
11,9,0,2,FBS Independents,,East Carolina,1986,N,N
11,5,0,6,Mid-American,,Eastern Michigan,1986,N,N
11,5,0,6,SEC,,Florida,1986,N,N
12,5,0,7,FBS Independents,,Florida State,1986,N,N
11,2,0,9,PCAA,,Fresno State,1986,N,N
12,4,0,8,SEC,,Georgia,1986,N,N
11,6,0,5,ACC,,Georgia Tech,1986,N,N
12,5,0,7,Western Athletic,,Hawai'i,1986,N,N
11,10,0,1,Southwest,,Houston,1986,N,N
11,7,0,4,Big Ten,,Illinois,1986,N,N
12,6,0,6,Big Ten,,Indiana,1986,N,N
12,3,0,9,Big Ten,,Iowa,1986,N,N
11,5,0,6,Big 8,,Iowa State,1986,N,N
11,8,0,3,Big 8,,Kansas,1986,N,N
11,9,0,2,Big 8,,Kansas State,1986,N,N
11,6,0,5,Mid-American,,Kent State,1986,N,N
11,6,0,5,SEC,,Kentucky,1986,N,N
11,5,0,6,PCAA,,Long Beach State,1986,N,N
11,5,0,6,FBS Independents,,Louisiana,1986,N,N
11,8,0,3,FBS Independents,,Louisville,1986,N,N
12,3,0,9,SEC,,LSU,1986,N,N
11,6,0,5,ACC,,Maryland,1986,N,N
11,10,0,1,FBS Independents,,Memphis,1986,N,N
12,1,0,11,FBS Independents,,Miami,1986,N,N
12,4,0,8,Mid-American,,Miami (OH),1986,N,N
13,2,0,11,Big Ten,,Michigan,1986,N,N
11,5,0,6,Big Ten,,Michigan State,1986,N,N
12,6,0,6,Big Ten,,Minnesota,1986,N,N
11,5,0,6,SEC,,Mississippi State,1986,N,N
11,8,0,3,Big 8,,Missouri,1986,N,N
11,8,0,3,FBS Independents,,Navy,1986,N,N
12,4,0,8,ACC,,NC State,1986,N,N
12,2,0,10,Big 8,,Nebraska,1986,N,N
12,8,0,4,Western Athletic,,New Mexico,1986,N,N
11,10,0,1,PCAA,,New Mexico State,1986,N,N
12,4,0,8,ACC,,North Carolina,1986,N,N
11,9,0,2,FBS Independents,,Northern Illinois,1986,N,N
11,7,0,4,Big Ten,,Northwestern,1986,N,N
11,6,0,5,FBS Independents,,Notre Dame,1986,N,N
11,10,0,1,Mid-American,,Ohio,1986,N,N
13,3,0,10,Big Ten,,Ohio State,1986,N,N
12,1,0,11,Big 8,,Oklahoma,1986,N,N
11,5,0,6,Big 8,,Oklahoma State,1986,N,N
12,4,0,8,SEC,,Ole Miss,1986,N,N
11,6,0,5,Pac-10,,Oregon,1986,N,N
11,8,0,3,Pac-10,,Oregon State,1986,N,N
11,7,0,4,PCAA,,Pacific,1986,N,N
12,0,0,12,FBS Independents,,Penn State,1986,Y,N
11,5,0,6,FBS Independents,,Pittsburgh,1986,N,N
11,8,0,3,Big Ten,,Purdue,1986,N,N
11,7,0,4,Southwest,,Rice,1986,N,N
11,5,0,6,FBS Independents,,Rutgers,1986,N,N
12,4,0,8,Western Athletic,,San Diego State,1986,N,N
12,2,0,10,PCAA,,San Josï¿½ State,1986,N,N
11,5,0,6,Southwest,,SMU,1986,N,N
11,6,0,5,FBS Independents,,South Carolina,1986,N,N
11,5,0,6,FBS Independents,,Southern Mississippi,1986,N,N
12,4,0,8,Pac-10,,Stanford,1986,N,N
11,6,0,5,FBS Independents,,Syracuse,1986,N,N
11,8,0,3,Southwest,,TCU,1986,N,N
11,5,0,6,FBS Independents,,Temple,1986,N,N
12,5,0,7,SEC,,Tennessee,1986,N,N
11,6,0,5,Southwest,,Texas,1986,N,N
12,3,0,9,Southwest,,Texas A&M,1986,N,N
12,5,0,7,Southwest,,Texas Tech,1986,N,N
11,4,0,7,Mid-American,,Toledo,1986,N,N
11,7,0,4,FBS Independents,,Tulane,1986,N,N
11,4,0,7,FBS Independents,,Tulsa,1986,N,N
12,3,0,9,Pac-10,,UCLA,1986,N,N
11,5,0,6,PCAA,,UNLV,1986,N,N
12,5,0,7,Pac-10,,USC,1986,N,N
11,9,0,2,Western Athletic,,Utah,1986,N,N
11,8,0,3,PCAA,,Utah State,1986,N,N
12,8,0,4,Western Athletic,,UTEP,1986,N,N
11,10,0,1,SEC,,Vanderbilt,1986,N,N
11,8,0,3,ACC,,Virginia,1986,N,N
12,3,0,9,FBS Independents,,Virginia Tech,1986,N,N
11,6,0,5,ACC,,Wake Forest,1986,N,N
12,4,0,8,Pac-10,,Washington,1986,N,N
11,7,0,4,Pac-10,,Washington State,1986,N,N
11,8,0,3,Mid-American,,Western Michigan,1986,N,N
11,7,0,4,FBS Independents,,West Virginia,1986,N,N
11,8,0,3,FBS Independents,,Wichita State,1986,N,N
12,9,0,3,Big Ten,,Wisconsin,1986,N,N
12,6,0,6,Western Athletic,,Wyoming,1986,N,N
13,4,0,9,Western Athletic,,Air Force,1987,N,N
11,7,0,4,FBS Independents,,Akron,1987,N,N
12,5,0,7,SEC,,Alabama,1987,N,N
11,5,0,6,Pac-10,,Arizona,1987,N,N
12,5,0,7,Pac-10,,Arizona State,1987,N,N
13,4,0,9,Southwest,,Arkansas,1987,N,N
11,6,0,5,FBS Independents,,Army,1987,N,N
12,2,0,10,SEC,,Auburn,1987,N,N
11,7,0,4,Mid-American,,Ball State,1987,N,N
11,5,0,6,Southwest,,Baylor,1987,N,N
11,6,0,5,FBS Independents,,Boston College,1987,N,N
11,6,0,5,Mid-American,,Bowling Green,1987,N,N
13,4,0,9,Western Athletic,,BYU,1987,N,N
11,8,0,3,Pac-10,,California,1987,N,N
12,6,0,6,PCAA,,Cal State Fullerton,1987,N,N
11,6,0,5,Mid-American,,Central Michigan,1987,N,N
11,7,0,4,FBS Independents,,Cincinnati,1987,N,N
12,2,0,10,ACC,,Clemson,1987,N,N
11,4,0,7,Big 8,,Colorado,1987,N,N
12,11,0,1,Western Athletic,,Colorado State,1987,N,N
11,6,0,5,ACC,,Duke,1987,N,N
11,6,0,5,FBS Independents,,East Carolina,1987,N,N
12,2,0,10,Mid-American,,Eastern Michigan,1987,N,N
12,6,0,6,SEC,,Florida,1987,N,N
12,1,0,11,FBS Independents,,Florida State,1987,N,N
11,5,0,6,PCAA,,Fresno State,1987,N,N
12,3,0,9,SEC,,Georgia,1987,N,N
11,9,0,2,ACC,,Georgia Tech,1987,N,N
12,7,0,5,Western Athletic,,Hawai'i,1987,N,N
11,7,0,4,Southwest,,Houston,1987,N,N
11,7,0,4,Big Ten,,Illinois,1987,N,N
12,4,0,8,Big Ten,,Indiana,1987,N,N
13,3,0,10,Big Ten,,Iowa,1987,N,N
11,8,0,3,Big 8,,Iowa State,1987,N,N
11,9,0,2,Big 8,,Kansas,1987,N,N
11,11,0,0,Big 8,,Kansas State,1987,N,N
11,4,0,7,Mid-American,,Kent State,1987,N,N
11,6,0,5,SEC,,Kentucky,1987,N,N
11,7,0,4,PCAA,,Long Beach State,1987,N,N
11,5,0,6,FBS Independents,,Louisiana,1987,N,N
11,7,0,4,FBS Independents,,Louisville,1987,N,N
12,2,0,10,SEC,,LSU,1987,N,N
11,7,0,4,ACC,,Maryland,1987,N,N
11,6,0,5,FBS Independents,,Memphis,1987,N,N
12,0,0,12,FBS Independents,,Miami,1987,Y,N
11,6,0,5,Mid-American,,Miami (OH),1987,N,N
12,4,0,8,Big Ten,,Michigan,1987,N,N
12,3,0,9,Big Ten,,Michigan State,1987,N,N
11,5,0,6,Big Ten,,Minnesota,1987,N,N
11,7,0,4,SEC,,Mississippi State,1987,N,N
11,6,0,5,Big 8,,Missouri,1987,N,N
11,9,0,2,FBS Independents,,Navy,1987,N,N
11,7,0,4,ACC,,NC State,1987,N,N
12,2,0,10,Big 8,,Nebraska,1987,N,N
11,11,0,0,Western Athletic,,New Mexico,1987,N,N
11,9,0,2,PCAA,,New Mexico State,1987,N,N
11,6,0,5,ACC,,North Carolina,1987,N,N
11,5,0,6,FBS Independents,,Northern Illinois,1987,N,N
11,9,0,2,Big Ten,,Northwestern,1987,N,N
12,4,0,8,FBS Independents,,Notre Dame,1987,N,N
11,10,0,1,Mid-American,,Ohio,1987,N,N
11,4,0,7,Big Ten,,Ohio State,1987,N,N
12,1,0,11,Big 8,,Oklahoma,1987,N,N
12,2,0,10,Big 8,,Oklahoma State,1987,N,N
11,8,0,3,SEC,,Ole Miss,1987,N,N
11,5,0,6,Pac-10,,Oregon,1987,N,N
11,9,0,2,Pac-10,,Oregon State,1987,N,N
11,7,0,4,PCAA,,Pacific,1987,N,N
12,4,0,8,FBS Independents,,Penn State,1987,N,N
12,4,0,8,FBS Independents,,Pittsburgh,1987,N,N
11,8,0,3,Big Ten,,Purdue,1987,N,N
11,9,0,2,Southwest,,Rice,1987,N,N
11,5,0,6,FBS Independents,,Rutgers,1987,N,N
12,7,0,5,Western Athletic,,San Diego State,1987,N,N
12,2,0,10,PCAA,,San Josï¿½ State,1987,N,N
12,4,0,8,FBS Independents,,South Carolina,1987,N,N
11,5,0,6,FBS Independents,,Southern Mississippi,1987,N,N
11,6,0,5,Pac-10,,Stanford,1987,N,N
12,0,0,12,FBS Independents,,Syracuse,1987,N,N
11,6,0,5,Southwest,,TCU,1987,N,N
11,8,0,3,FBS Independents,,Temple,1987,N,N
13,3,0,10,SEC,,Tennessee,1987,N,N
12,5,0,7,Southwest,,Texas,1987,N,N
12,2,0,10,Southwest,,Texas A&M,1987,N,N
11,4,0,7,Southwest,,Texas Tech,1987,N,N
11,7,0,4,Mid-American,,Toledo,1987,N,N
12,6,0,6,FBS Independents,,Tulane,1987,N,N
11,8,0,3,FBS Independents,,Tulsa,1987,N,N
12,2,0,10,Pac-10,,UCLA,1987,N,N
11,6,0,5,PCAA,,UNLV,1987,N,N
12,4,0,8,Pac-10,,USC,1987,N,N
12,7,0,5,Western Athletic,,Utah,1987,N,N
11,6,0,5,PCAA,,Utah State,1987,N,N
11,4,0,7,Western Athletic,,UTEP,1987,N,N
11,7,0,4,SEC,,Vanderbilt,1987,N,N
12,4,0,8,ACC,,Virginia,1987,N,N
11,9,0,2,FBS Independents,,Virginia Tech,1987,N,N
11,4,0,7,ACC,,Wake Forest,1987,N,N
12,4,0,8,Pac-10,,Washington,1987,N,N
11,7,0,4,Pac-10,,Washington State,1987,N,N
11,6,0,5,Mid-American,,Western Michigan,1987,N,N
12,6,0,6,FBS Independents,,West Virginia,1987,N,N
11,8,0,3,Big Ten,,Wisconsin,1987,N,N
13,3,0,10,Western Athletic,,Wyoming,1987,N,N
12,7,0,5,Western Athletic,,Air Force,1988,N,N
11,6,0,5,FBS Independents,,Akron,1988,N,N
12,3,0,9,SEC,,Alabama,1988,N,N
11,4,0,7,Pac-10,,Arizona,1988,N,N
11,5,0,6,Pac-10,,Arizona State,1988,N,N
12,2,0,10,Southwest,,Arkansas,1988,N,N
12,3,0,9,FBS Independents,,Army,1988,N,N
12,2,0,10,SEC,,Auburn,1988,N,N
11,3,0,8,Mid-American,,Ball State,1988,N,N
11,5,0,6,Southwest,,Baylor,1988,N,N
11,8,0,3,FBS Independents,,Boston College,1988,N,N
11,9,0,2,Mid-American,,Bowling Green,1988,N,N
13,4,0,9,Western Athletic,,BYU,1988,N,N
11,6,0,5,Pac-10,,California,1988,N,N
11,6,0,5,Big West,,Cal State Fullerton,1988,N,N
11,4,0,7,Mid-American,,Central Michigan,1988,N,N
11,8,0,3,FBS Independents,,Cincinnati,1988,N,N
12,2,0,10,ACC,,Clemson,1988,N,N
12,4,0,8,Big 8,,Colorado,1988,N,N
11,10,0,1,Western Athletic,,Colorado State,1988,N,N
11,3,0,8,ACC,,Duke,1988,N,N
11,8,0,3,FBS Independents,,East Carolina,1988,N,N
10,3,0,7,Mid-American,,Eastern Michigan,1988,N,N
12,5,0,7,SEC,,Florida,1988,N,N
12,1,0,11,FBS Independents,,Florida State,1988,N,N
12,2,0,10,Big West,,Fresno State,1988,N,N
12,3,0,9,SEC,,Georgia,1988,N,N
11,8,0,3,ACC,,Georgia Tech,1988,N,N
12,3,0,9,Western Athletic,,Hawai'i,1988,N,N
12,3,0,9,Southwest,,Houston,1988,N,N
12,5,0,7,Big Ten,,Illinois,1988,N,N
12,3,0,9,Big Ten,,Indiana,1988,N,N
13,6,0,7,Big Ten,,Iowa,1988,N,N
11,6,0,5,Big 8,,Iowa State,1988,N,N
11,10,0,1,Big 8,,Kansas,1988,N,N
11,11,0,0,Big 8,,Kansas State,1988,N,N
11,6,0,5,Mid-American,,Kent State,1988,N,N
11,6,0,5,SEC,,Kentucky,1988,N,N
12,9,0,3,Big West,,Long Beach State,1988,N,N
11,5,0,6,FBS Independents,,Louisiana,1988,N,N
11,7,0,4,FBS Independents,,Louisiana Tech,1988,N,N
11,3,0,8,FBS Independents,,Louisville,1988,N,N
12,4,0,8,SEC,,LSU,1988,N,N
11,6,0,5,ACC,,Maryland,1988,N,N
11,5,0,6,FBS Independents,,Memphis,1988,N,N
12,1,0,11,FBS Independents,,Miami,1988,N,N
11,10,0,1,Mid-American,,Miami (OH),1988,N,N
12,2,0,10,Big Ten,,Michigan,1988,N,N
12,6,0,6,Big Ten,,Michigan State,1988,N,N
11,9,0,2,Big Ten,,Minnesota,1988,N,N
11,10,0,1,SEC,,Mississippi State,1988,N,N
11,8,0,3,Big 8,,Missouri,1988,N,N
11,8,0,3,FBS Independents,,Navy,1988,N,N
12,4,0,8,ACC,,NC State,1988,N,N
13,2,0,11,Big 8,,Nebraska,1988,N,N
12,10,0,2,Western Athletic,,New Mexico,1988,N,N
11,10,0,1,Big West,,New Mexico State,1988,N,N
11,10,0,1,ACC,,North Carolina,1988,N,N
11,4,0,7,FBS Independents,,Northern Illinois,1988,N,N
11,8,0,3,Big Ten,,Northwestern,1988,N,N
12,0,0,12,FBS Independents,,Notre Dame,1988,Y,N
11,7,0,4,Mid-American,,Ohio,1988,N,N
11,6,0,5,Big Ten,,Ohio State,1988,N,N
12,3,0,9,Big 8,,Oklahoma,1988,N,N
12,2,0,10,Big 8,,Oklahoma State,1988,N,N
11,6,0,5,SEC,,Ole Miss,1988,N,N
12,6,0,6,Pac-10,,Oregon,1988,N,N
11,6,0,5,Pac-10,,Oregon State,1988,N,N
11,9,0,2,Big West,,Pacific,1988,N,N
11,6,0,5,FBS Independents,,Penn State,1988,N,N
11,5,0,6,FBS Independents,,Pittsburgh,1988,N,N
11,7,0,4,Big Ten,,Purdue,1988,N,N
11,11,0,0,Southwest,,Rice,1988,N,N
11,6,0,5,FBS Independents,,Rutgers,1988,N,N
11,8,0,3,Western Athletic,,San Diego State,1988,N,N
12,8,0,4,Big West,,San Josï¿½ State,1988,N,N
12,4,0,8,FBS Independents,,South Carolina,1988,N,N
12,2,0,10,FBS Independents,,Southern Mississippi,1988,N,N
11,7,0,4,Pac-10,,Stanford,1988,N,N
12,2,0,10,FBS Independents,,Syracuse,1988,N,N
11,7,0,4,Southwest,,TCU,1988,N,N
11,7,0,4,FBS Independents,,Temple,1988,N,N
11,6,0,5,SEC,,Tennessee,1988,N,N
11,7,0,4,Southwest,,Texas,1988,N,N
12,5,0,7,Southwest,,Texas A&M,1988,N,N
11,6,0,5,Southwest,,Texas Tech,1988,N,N
11,5,0,6,Mid-American,,Toledo,1988,N,N
11,6,0,5,FBS Independents,,Tulane,1988,N,N
11,7,0,4,FBS Independents,,Tulsa,1988,N,N
12,2,0,10,Pac-10,,UCLA,1988,N,N
11,7,0,4,Big West,,UNLV,1988,N,N
12,2,0,10,Pac-10,,USC,1988,N,N
11,5,0,6,Western Athletic,,Utah,1988,N,N
11,7,0,4,Big West,,Utah State,1988,N,N
13,3,0,10,Western Athletic,,UTEP,1988,N,N
11,8,0,3,SEC,,Vanderbilt,1988,N,N
11,4,0,7,ACC,,Virginia,1988,N,N
11,8,0,3,FBS Independents,,Virginia Tech,1988,N,N
11,5,0,6,ACC,,Wake Forest,1988,N,N
11,5,0,6,Pac-10,,Washington,1988,N,N
12,3,0,9,Pac-10,,Washington State,1988,N,N
12,3,0,9,Mid-American,,Western Michigan,1988,N,N
12,1,0,11,FBS Independents,,West Virginia,1988,N,N
11,10,0,1,Big Ten,,Wisconsin,1988,N,N
13,2,0,11,Western Athletic,,Wyoming,1988,N,N
13,4,0,9,Western Athletic,,Air Force,1989,N,N
11,4,0,7,FBS Independents,,Akron,1989,N,N
12,2,0,10,SEC,,Alabama,1989,N,N
12,4,0,8,Pac-10,,Arizona,1989,N,N
11,4,0,7,Pac-10,,Arizona State,1989,N,N
12,2,0,10,Southwest,,Arkansas,1989,N,N
11,5,0,6,FBS Independents,,Army,1989,N,N
12,2,0,10,SEC,,Auburn,1989,N,N
12,4,0,8,Mid-American,,Ball State,1989,N,N
11,6,0,5,Southwest,,Baylor,1989,N,N
11,9,0,2,FBS Independents,,Boston College,1989,N,N
11,6,0,5,Mid-American,,Bowling Green,1989,N,N
13,3,0,10,Western Athletic,,BYU,1989,N,N
11,7,0,4,Pac-10,,California,1989,N,N
11,4,0,7,Big West,,Cal State Fullerton,1989,N,N
11,5,0,6,Mid-American,,Central Michigan,1989,N,N
11,10,0,1,FBS Independents,,Cincinnati,1989,N,N
12,2,0,10,ACC,,Clemson,1989,N,N
12,1,0,11,Big 8,,Colorado,1989,N,N
11,6,0,5,Western Athletic,,Colorado State,1989,N,N
12,4,0,8,ACC,,Duke,1989,N,N
11,6,0,5,FBS Independents,,East Carolina,1989,N,N
11,3,0,8,Mid-American,,Eastern Michigan,1989,N,N
12,5,0,7,SEC,,Florida,1989,N,N
12,2,0,10,FBS Independents,,Florida State,1989,N,N
12,1,0,11,Big West,,Fresno State,1989,N,N
12,6,0,6,SEC,,Georgia,1989,N,N
11,4,0,7,ACC,,Georgia Tech,1989,N,N
13,4,0,9,Western Athletic,,Hawai'i,1989,N,N
11,2,0,9,Southwest,,Houston,1989,N,N
12,2,0,10,Big Ten,,Illinois,1989,N,N
11,6,0,5,Big Ten,,Indiana,1989,N,N
11,6,0,5,Big Ten,,Iowa,1989,N,N
11,5,0,6,Big 8,,Iowa State,1989,N,N
11,7,0,4,Big 8,,Kansas,1989,N,N
11,10,0,1,Big 8,,Kansas State,1989,N,N
11,11,0,0,Mid-American,,Kent State,1989,N,N
11,5,0,6,SEC,,Kentucky,1989,N,N
12,8,0,4,Big West,,Long Beach State,1989,N,N
11,4,0,7,FBS Independents,,Louisiana,1989,N,N
10,4,0,6,FBS Independents,,Louisiana Tech,1989,N,N
11,5,0,6,FBS Independents,,Louisville,1989,N,N
11,7,0,4,SEC,,LSU,1989,N,N
11,8,0,3,ACC,,Maryland,1989,N,N
11,9,0,2,FBS Independents,,Memphis,1989,N,N
12,1,0,11,FBS Independents,,Miami,1989,Y,N
11,9,0,2,Mid-American,,Miami (OH),1989,N,N
12,2,0,10,Big Ten,,Michigan,1989,N,N
12,4,0,8,Big Ten,,Michigan State,1989,N,N
11,5,0,6,Big Ten,,Minnesota,1989,N,N
11,6,0,5,SEC,,Mississippi State,1989,N,N
11,9,0,2,Big 8,,Missouri,1989,N,N
11,8,0,3,FBS Independents,,Navy,1989,N,N
12,5,0,7,ACC,,NC State,1989,N,N
12,2,0,10,Big 8,,Nebraska,1989,N,N
12,10,0,2,Western Athletic,,New Mexico,1989,N,N
11,11,0,0,Big West,,New Mexico State,1989,N,N
11,10,0,1,ACC,,North Carolina,1989,N,N
11,2,0,9,FBS Independents,,Northern Illinois,1989,N,N
11,11,0,0,Big Ten,,Northwestern,1989,N,N
13,1,0,12,FBS Independents,,Notre Dame,1989,N,N
11,9,0,2,Mid-American,,Ohio,1989,N,N
12,4,0,8,Big Ten,,Ohio State,1989,N,N
11,4,0,7,Big 8,,Oklahoma,1989,N,N
11,7,0,4,Big 8,,Oklahoma State,1989,N,N
12,4,0,8,SEC,,Ole Miss,1989,N,N
12,4,0,8,Pac-10,,Oregon,1989,N,N
12,8,0,4,Pac-10,,Oregon State,1989,N,N
12,10,0,2,Big West,,Pacific,1989,N,N
12,3,0,9,FBS Independents,,Penn State,1989,N,N
12,3,0,9,FBS Independents,,Pittsburgh,1989,N,N
11,8,0,3,Big Ten,,Purdue,1989,N,N
11,8,0,3,Southwest,,Rice,1989,N,N
11,8,0,3,FBS Independents,,Rutgers,1989,N,N
12,6,0,6,Western Athletic,,San Diego State,1989,N,N
11,5,0,6,Big West,,San Josï¿½ State,1989,N,N
11,9,0,2,Southwest,,SMU,1989,N,N
11,5,0,6,FBS Independents,,South Carolina,1989,N,N
11,6,0,5,FBS Independents,,Southern Mississippi,1989,N,N
11,8,0,3,Pac-10,,Stanford,1989,N,N
12,4,0,8,FBS Independents,,Syracuse,1989,N,N
11,7,0,4,Southwest,,TCU,1989,N,N
11,10,0,1,FBS Independents,,Temple,1989,N,N
12,1,0,11,SEC,,Tennessee,1989,N,N
11,6,0,5,Southwest,,Texas,1989,N,N
12,4,0,8,Southwest,,Texas A&M,1989,N,N
12,3,0,9,Southwest,,Texas Tech,1989,N,N
11,5,0,6,Mid-American,,Toledo,1989,N,N
12,8,0,4,FBS Independents,,Tulane,1989,N,N
12,6,0,6,FBS Independents,,Tulsa,1989,N,N
11,7,0,4,Pac-10,,UCLA,1989,N,N
11,7,0,4,Big West,,UNLV,1989,N,N
12,3,0,9,Pac-10,,USC,1989,N,N
12,8,0,4,Western Athletic,,Utah,1989,N,N
11,7,0,4,Big West,,Utah State,1989,N,N
12,10,0,2,Western Athletic,,UTEP,1989,N,N
11,10,0,1,SEC,,Vanderbilt,1989,N,N
13,3,0,10,ACC,,Virginia,1989,N,N
11,4,0,7,FBS Independents,,Virginia Tech,1989,N,N
11,9,0,2,ACC,,Wake Forest,1989,N,N
12,4,0,8,Pac-10,,Washington,1989,N,N
11,5,0,6,Pac-10,,Washington State,1989,N,N
11,6,0,5,Mid-American,,Western Michigan,1989,N,N
12,4,0,8,FBS Independents,,West Virginia,1989,N,N
11,9,0,2,Big Ten,,Wisconsin,1989,N,N
11,6,0,5,Western Athletic,,Wyoming,1989,N,N
12,5,0,7,Western Athletic,,Air Force,1990,N,N
11,8,0,3,FBS Independents,,Akron,1990,N,N
12,5,0,7,SEC,,Alabama,1990,N,N
12,5,0,7,Pac-10,,Arizona,1990,N,N
11,7,0,4,Pac-10,,Arizona State,1990,N,N
11,8,0,3,Southwest,,Arkansas,1990,N,N
11,7,0,4,FBS Independents,,Arkansas State,1990,N,N
11,5,0,6,FBS Independents,,Army,1990,N,N
12,4,0,8,SEC,,Auburn,1990,N,N
11,4,0,7,Mid-American,,Ball State,1990,N,N
11,4,0,7,Southwest,,Baylor,1990,N,N
11,7,0,4,FBS Independents,,Boston College,1990,N,N
10,7,0,3,Mid-American,,Bowling Green,1990,N,N
13,3,0,10,Western Athletic,,BYU,1990,N,N
12,4,0,8,Pac-10,,California,1990,N,N
12,11,0,1,Big West,,Cal State Fullerton,1990,N,N
12,3,0,9,Mid-American,,Central Michigan,1990,N,N
11,10,0,1,FBS Independents,,Cincinnati,1990,N,N
12,2,0,10,ACC,,Clemson,1990,N,N
13,2,0,11,Big 8,,Colorado,1990,N,N
13,4,0,9,Western Athletic,,Colorado State,1990,N,N
11,7,0,4,ACC,,Duke,1990,N,N
11,6,0,5,FBS Independents,,East Carolina,1990,N,N
11,9,0,2,Mid-American,,Eastern Michigan,1990,N,N
11,2,0,9,SEC,,Florida,1990,N,N
12,2,0,10,FBS Independents,,Florida State,1990,N,N
11,3,0,8,Big West,,Fresno State,1990,N,N
11,7,0,4,SEC,,Georgia,1990,N,N
12,0,0,12,ACC,,Georgia Tech,1990,Y,N
12,5,0,7,Western Athletic,,Hawai'i,1990,N,N
11,1,0,10,Southwest,,Houston,1990,N,N
12,4,0,8,Big Ten,,Illinois,1990,N,N
12,6,0,6,Big Ten,,Indiana,1990,N,N
12,4,0,8,Big Ten,,Iowa,1990,N,N
11,7,0,4,Big 8,,Iowa State,1990,N,N
11,7,0,4,Big 8,,Kansas,1990,N,N
11,6,0,5,Big 8,,Kansas State,1990,N,N
11,9,0,2,Mid-American,,Kent State,1990,N,N
11,7,0,4,SEC,,Kentucky,1990,N,N
11,5,0,6,Big West,,Long Beach State,1990,N,N
11,6,0,5,FBS Independents,,Louisiana,1990,N,N
12,4,0,8,FBS Independents,,Louisiana Tech,1990,N,N
12,1,0,11,FBS Independents,,Louisville,1990,N,N
11,6,0,5,SEC,,LSU,1990,N,N
12,5,0,7,ACC,,Maryland,1990,N,N
11,7,0,4,FBS Independents,,Memphis,1990,N,N
12,2,0,10,FBS Independents,,Miami,1990,N,N
11,5,0,6,Mid-American,,Miami (OH),1990,N,N
12,3,0,9,Big Ten,,Michigan,1990,N,N
12,3,0,9,Big Ten,,Michigan State,1990,N,N
11,5,0,6,Big Ten,,Minnesota,1990,N,N
11,6,0,5,SEC,,Mississippi State,1990,N,N
11,7,0,4,Big 8,,Missouri,1990,N,N
11,6,0,5,FBS Independents,,Navy,1990,N,N
12,5,0,7,ACC,,NC State,1990,N,N
12,3,0,9,Big 8,,Nebraska,1990,N,N
12,10,0,2,Western Athletic,,New Mexico,1990,N,N
11,10,0,1,Big West,,New Mexico State,1990,N,N
11,5,0,6,ACC,,North Carolina,1990,N,N
11,5,0,6,FBS Independents,,Northern Illinois,1990,N,N
11,9,0,2,Big Ten,,Northwestern,1990,N,N
12,3,0,9,FBS Independents,,Notre Dame,1990,N,N
11,9,0,2,Mid-American,,Ohio,1990,N,N
12,4,0,8,Big Ten,,Ohio State,1990,N,N
11,3,0,8,Big 8,,Oklahoma,1990,N,N
11,7,0,4,Big 8,,Oklahoma State,1990,N,N
12,3,0,9,SEC,,Ole Miss,1990,N,N
12,4,0,8,Pac-10,,Oregon,1990,N,N
11,10,0,1,Pac-10,,Oregon State,1990,N,N
11,7,0,4,Big West,,Pacific,1990,N,N
12,3,0,9,FBS Independents,,Penn State,1990,N,N
11,7,0,4,FBS Independents,,Pittsburgh,1990,N,N
11,9,0,2,Big Ten,,Purdue,1990,N,N
11,6,0,5,Southwest,,Rice,1990,N,N
11,8,0,3,FBS Independents,,Rutgers,1990,N,N
11,5,0,6,Western Athletic,,San Diego State,1990,N,N
12,3,0,9,Big West,,San Josï¿½ State,1990,N,N
11,10,0,1,Southwest,,SMU,1990,N,N
11,5,0,6,FBS Independents,,South Carolina,1990,N,N
12,4,0,8,FBS Independents,,Southern Mississippi,1990,N,N
11,6,0,5,Pac-10,,Stanford,1990,N,N
13,6,0,7,FBS Independents,,Syracuse,1990,N,N
11,6,0,5,Southwest,,TCU,1990,N,N
11,4,0,7,FBS Independents,,Temple,1990,N,N
13,2,0,11,SEC,,Tennessee,1990,N,N
12,2,0,10,Southwest,,Texas,1990,N,N
13,4,0,9,Southwest,,Texas A&M,1990,N,N
11,7,0,4,Southwest,,Texas Tech,1990,N,N
11,2,0,9,Mid-American,,Toledo,1990,N,N
11,7,0,4,FBS Independents,,Tulane,1990,N,N
11,8,0,3,FBS Independents,,Tulsa,1990,N,N
11,6,0,5,Pac-10,,UCLA,1990,N,N
11,7,0,4,Big West,,UNLV,1990,N,N
13,5,0,8,Pac-10,,USC,1990,N,N
11,7,0,4,Western Athletic,,Utah,1990,N,N
11,5,0,6,Big West,,Utah State,1990,N,N
11,8,0,3,Western Athletic,,UTEP,1990,N,N
11,10,0,1,SEC,,Vanderbilt,1990,N,N
12,4,0,8,ACC,,Virginia,1990,N,N
11,5,0,6,FBS Independents,,Virginia Tech,1990,N,N
11,8,0,3,ACC,,Wake Forest,1990,N,N
12,2,0,10,Pac-10,,Washington,1990,N,N
11,8,0,3,Pac-10,,Washington State,1990,N,N
11,4,0,7,Mid-American,,Western Michigan,1990,N,N
11,7,0,4,FBS Independents,,West Virginia,1990,N,N
11,10,0,1,Big Ten,,Wisconsin,1990,N,N
13,4,0,9,Western Athletic,,Wyoming,1990,N,N
13,3,0,10,Western Athletic,,Air Force,1991,N,N
11,6,0,5,FBS Independents,,Akron,1991,N,N
12,1,0,11,SEC,,Alabama,1991,N,N
11,7,0,4,Pac-10,,Arizona,1991,N,N
11,5,0,6,Pac-10,,Arizona State,1991,N,N
12,6,0,6,Southwest,,Arkansas,1991,N,N
11,10,0,1,FBS Independents,,Arkansas State,1991,N,N
11,7,0,4,FBS Independents,,Army,1991,N,N
11,6,0,5,SEC,,Auburn,1991,N,N
11,5,0,6,Mid-American,,Ball State,1991,N,N
12,4,0,8,Southwest,,Baylor,1991,N,N
11,7,0,4,Big East,,Boston College,1991,N,N
12,1,0,11,Mid-American,,Bowling Green,1991,N,N
13,4,0,9,Western Athletic,,BYU,1991,N,N
12,2,0,10,Pac-10,,California,1991,N,N
11,9,0,2,Big West,,Cal State Fullerton,1991,N,N
11,2,0,9,Mid-American,,Central Michigan,1991,N,N
11,7,0,4,FBS Independents,,Cincinnati,1991,N,N
12,3,0,9,ACC,,Clemson,1991,N,N
12,4,0,8,Big 8,,Colorado,1991,N,N
11,8,0,3,Western Athletic,,Colorado State,1991,N,N
11,6,0,5,ACC,,Duke,1991,N,N
12,1,0,11,FBS Independents,,East Carolina,1991,N,N
11,8,0,3,Mid-American,,Eastern Michigan,1991,N,N
12,2,0,10,SEC,,Florida,1991,N,N
13,2,0,11,FBS Independents,,Florida State,1991,N,N
12,2,0,10,Big West,,Fresno State,1991,N,N
12,3,0,9,SEC,,Georgia,1991,N,N
13,5,0,8,ACC,,Georgia Tech,1991,N,N
12,7,0,5,Western Athletic,,Hawai'i,1991,N,N
11,7,0,4,Southwest,,Houston,1991,N,N
12,6,0,6,Big Ten,,Illinois,1991,N,N
12,4,0,8,Big Ten,,Indiana,1991,N,N
12,1,0,11,Big Ten,,Iowa,1991,N,N
11,8,0,3,Big 8,,Iowa State,1991,N,N
11,5,0,6,Big 8,,Kansas,1991,N,N
11,4,0,7,Big 8,,Kansas State,1991,N,N
11,10,0,1,Mid-American,,Kent State,1991,N,N
11,8,0,3,SEC,,Kentucky,1991,N,N
11,9,0,2,Big West,,Long Beach State,1991,N,N
11,9,0,2,FBS Independents,,Louisiana,1991,N,N
11,1,0,10,FBS Independents,,Louisiana Tech,1991,N,N
11,9,0,2,FBS Independents,,Louisville,1991,N,N
11,6,0,5,SEC,,LSU,1991,N,N
11,9,0,2,ACC,,Maryland,1991,N,N
11,6,0,5,FBS Independents,,Memphis,1991,N,N
12,0,0,12,Big East,,Miami,1991,Y,N
11,4,0,7,Mid-American,,Miami (OH),1991,N,N
12,2,0,10,Big Ten,,Michigan,1991,N,N
11,8,0,3,Big Ten,,Michigan State,1991,N,N
11,9,0,2,Big Ten,,Minnesota,1991,N,N
12,5,0,7,SEC,,Mississippi State,1991,N,N
11,8,0,3,Big 8,,Missouri,1991,N,N
11,10,0,1,FBS Independents,,Navy,1991,N,N
12,3,0,9,ACC,,NC State,1991,N,N
12,2,0,10,Big 8,,Nebraska,1991,N,N
12,9,0,3,Western Athletic,,New Mexico,1991,N,N
11,9,0,2,Big West,,New Mexico State,1991,N,N
11,4,0,7,ACC,,North Carolina,1991,N,N
11,9,0,2,FBS Independents,,Northern Illinois,1991,N,N
11,8,0,3,Big Ten,,Northwestern,1991,N,N
13,3,0,10,FBS Independents,,Notre Dame,1991,N,N
11,9,0,2,Mid-American,,Ohio,1991,N,N
12,4,0,8,Big Ten,,Ohio State,1991,N,N
12,3,0,9,Big 8,,Oklahoma,1991,N,N
11,10,0,1,Big 8,,Oklahoma State,1991,N,N
11,6,0,5,SEC,,Ole Miss,1991,N,N
11,8,0,3,Pac-10,,Oregon,1991,N,N
11,10,0,1,Pac-10,,Oregon State,1991,N,N
12,7,0,5,Big West,,Pacific,1991,N,N
13,2,0,11,FBS Independents,,Penn State,1991,N,N
11,5,0,6,Big East,,Pittsburgh,1991,N,N
11,7,0,4,Big Ten,,Purdue,1991,N,N
11,7,0,4,Southwest,,Rice,1991,N,N
11,5,0,6,Big East,,Rutgers,1991,N,N
13,5,0,8,Western Athletic,,San Diego State,1991,N,N
11,5,0,6,Big West,,San Josï¿½ State,1991,N,N
11,10,0,1,Southwest,,SMU,1991,N,N
11,8,0,3,FBS Independents,,South Carolina,1991,N,N
11,7,0,4,FBS Independents,,Southern Mississippi,1991,N,N
12,4,0,8,Pac-10,,Stanford,1991,N,N
12,2,0,10,Big East,,Syracuse,1991,N,N
11,4,0,7,Southwest,,TCU,1991,N,N
11,9,0,2,Big East,,Temple,1991,N,N
12,3,0,9,SEC,,Tennessee,1991,N,N
11,6,0,5,Southwest,,Texas,1991,N,N
12,2,0,10,Southwest,,Texas A&M,1991,N,N
11,5,0,6,Southwest,,Texas Tech,1991,N,N
11,6,0,5,Mid-American,,Toledo,1991,N,N
11,10,0,1,FBS Independents,,Tulane,1991,N,N
12,2,0,10,FBS Independents,,Tulsa,1991,N,N
12,3,0,9,Pac-10,,UCLA,1991,N,N
11,7,0,4,Big West,,UNLV,1991,N,N
11,8,0,3,Pac-10,,USC,1991,N,N
12,5,0,7,Western Athletic,,Utah,1991,N,N
11,6,0,5,Big West,,Utah State,1991,N,N
12,7,0,5,Western Athletic,,UTEP,1991,N,N
11,6,0,5,SEC,,Vanderbilt,1991,N,N
12,3,0,9,ACC,,Virginia,1991,N,N
11,6,0,5,Big East,,Virginia Tech,1991,N,N
11,8,0,3,ACC,,Wake Forest,1991,N,N
12,0,0,12,Pac-10,,Washington,1991,Y,N
11,7,0,4,Pac-10,,Washington State,1991,N,N
11,5,0,6,Mid-American,,Western Michigan,1991,N,N
11,5,0,6,Big East,,West Virginia,1991,N,N
11,6,0,5,Big Ten,,Wisconsin,1991,N,N
11,7,0,4,Western Athletic,,Wyoming,1991,N,N
12,5,0,7,Western Athletic,,Air Force,1992,N,N
11,4,0,7,Mid-American,,Akron,1992,N,N
13,0,0,13,SEC,West,Alabama,1992,Y,N
12,5,0,7,Pac-10,,Arizona,1992,N,N
11,5,0,6,Pac-10,,Arizona State,1992,N,N
11,7,0,4,SEC,West,Arkansas,1992,N,N
11,9,0,2,FBS Independents,,Arkansas State,1992,N,N
11,6,0,5,FBS Independents,,Army,1992,N,N
11,6,0,5,SEC,West,Auburn,1992,N,N
11,6,0,5,Mid-American,,Ball State,1992,N,N
12,5,0,7,Southwest,,Baylor,1992,N,N
12,3,0,9,Big East,,Boston College,1992,N,N
12,2,0,10,Mid-American,,Bowling Green,1992,N,N
13,5,0,8,Western Athletic,,BYU,1992,N,N
11,7,0,4,Pac-10,,California,1992,N,N
11,9,0,2,Big West,,Cal State Fullerton,1992,N,N
11,6,0,5,Mid-American,,Central Michigan,1992,N,N
11,8,0,3,FBS Independents,,Cincinnati,1992,N,N
11,6,0,5,ACC,,Clemson,1992,N,N
12,3,0,9,Big 8,,Colorado,1992,N,N
12,7,0,5,Western Athletic,,Colorado State,1992,N,N
11,9,0,2,ACC,,Duke,1992,N,N
11,6,0,5,FBS Independents,,East Carolina,1992,N,N
11,10,0,1,Mid-American,,Eastern Michigan,1992,N,N
13,4,0,9,SEC,East,Florida,1992,N,N
12,1,0,11,ACC,,Florida State,1992,N,N
13,4,0,9,Western Athletic,,Fresno State,1992,N,N
12,2,0,10,SEC,East,Georgia,1992,N,N
11,6,0,5,ACC,,Georgia Tech,1992,N,N
13,2,0,11,Western Athletic,,Hawai'i,1992,N,N
11,7,0,4,Southwest,,Houston,1992,N,N
12,5,0,7,Big Ten,,Illinois,1992,N,N
11,6,0,5,Big Ten,,Indiana,1992,N,N
12,7,0,5,Big Ten,,Iowa,1992,N,N
11,7,0,4,Big 8,,Iowa State,1992,N,N
12,4,0,8,Big 8,,Kansas,1992,N,N
11,6,0,5,Big 8,,Kansas State,1992,N,N
11,9,0,2,Mid-American,,Kent State,1992,N,N
11,7,0,4,SEC,East,Kentucky,1992,N,N
11,9,0,2,FBS Independents,,Louisiana,1992,N,N
11,6,0,5,FBS Independents,,Louisiana Tech,1992,N,N
11,6,0,5,FBS Independents,,Louisville,1992,N,N
11,9,0,2,SEC,West,LSU,1992,N,N
11,8,0,3,ACC,,Maryland,1992,N,N
11,5,0,6,FBS Independents,,Memphis,1992,N,N
12,1,0,11,Big East,,Miami,1992,N,N
11,4,0,7,Mid-American,,Miami (OH),1992,N,N
12,1,0,11,Big Ten,,Michigan,1992,N,N
11,6,0,5,Big Ten,,Michigan State,1992,N,N
11,9,0,2,Big Ten,,Minnesota,1992,N,N
12,5,0,7,SEC,West,Mississippi State,1992,N,N
11,8,0,3,Big 8,,Missouri,1992,N,N
11,10,0,1,FBS Independents,,Navy,1992,N,N
13,3,0,10,ACC,,NC State,1992,N,N
12,3,0,9,Big 8,,Nebraska,1992,N,N
12,5,0,7,Big West,,Nevada,1992,N,N
11,8,0,3,Western Athletic,,New Mexico,1992,N,N
11,5,0,6,Big West,,New Mexico State,1992,N,N
12,3,0,9,ACC,,North Carolina,1992,N,N
11,6,0,5,FBS Independents,,Northern Illinois,1992,N,N
11,8,0,3,Big Ten,,Northwestern,1992,N,N
12,2,0,10,FBS Independents,,Notre Dame,1992,N,N
11,10,0,1,Mid-American,,Ohio,1992,N,N
12,4,0,8,Big Ten,,Ohio State,1992,N,N
11,4,0,7,Big 8,,Oklahoma,1992,N,N
11,7,0,4,Big 8,,Oklahoma State,1992,N,N
12,3,0,9,SEC,West,Ole Miss,1992,N,N
12,6,0,6,Pac-10,,Oregon,1992,N,N
11,10,0,1,Pac-10,,Oregon State,1992,N,N
11,8,0,3,Big West,,Pacific,1992,N,N
12,5,0,7,FBS Independents,,Penn State,1992,N,N
12,9,0,3,Big East,,Pittsburgh,1992,N,N
11,7,0,4,Big Ten,,Purdue,1992,N,N
11,5,0,6,Southwest,,Rice,1992,N,N
11,4,0,7,Big East,,Rutgers,1992,N,N
11,6,0,5,Western Athletic,,San Diego State,1992,N,N
11,4,0,7,Big West,,San Josï¿½ State,1992,N,N
11,6,0,5,Southwest,,SMU,1992,N,N
11,6,0,5,SEC,East,South Carolina,1992,N,N
11,4,0,7,FBS Independents,,Southern Mississippi,1992,N,N
13,3,0,10,Pac-10,,Stanford,1992,N,N
12,2,0,10,Big East,,Syracuse,1992,N,N
11,9,0,2,Southwest,,TCU,1992,N,N
11,10,0,1,Big East,,Temple,1992,N,N
12,3,0,9,SEC,East,Tennessee,1992,N,N
11,5,0,6,Southwest,,Texas,1992,N,N
13,1,0,12,Southwest,,Texas A&M,1992,N,N
11,6,0,5,Southwest,,Texas Tech,1992,N,N
11,3,0,8,Mid-American,,Toledo,1992,N,N
11,9,0,2,FBS Independents,,Tulane,1992,N,N
11,7,0,4,FBS Independents,,Tulsa,1992,N,N
11,5,0,6,Pac-10,,UCLA,1992,N,N
11,5,0,6,Big West,,UNLV,1992,N,N
12,5,0,7,Pac-10,,USC,1992,N,N
12,6,0,6,Western Athletic,,Utah,1992,N,N
11,6,0,5,Big West,,Utah State,1992,N,N
11,10,0,1,Western Athletic,,UTEP,1992,N,N
11,7,0,4,SEC,East,Vanderbilt,1992,N,N
11,4,0,7,ACC,,Virginia,1992,N,N
11,9,0,2,Big East,,Virginia Tech,1992,N,N
12,4,0,8,ACC,,Wake Forest,1992,N,N
12,3,0,9,Pac-10,,Washington,1992,N,N
12,3,0,9,Pac-10,,Washington State,1992,N,N
11,3,0,8,Mid-American,,Western Michigan,1992,N,N
11,6,0,5,Big East,,West Virginia,1992,N,N
11,6,0,5,Big Ten,,Wisconsin,1992,N,N
12,7,0,5,Western Athletic,,Wyoming,1992,N,N
12,8,0,4,Western Athletic,,Air Force,1993,N,N
11,6,0,5,Mid-American,,Akron,1993,N,N
13,4,0,9,SEC,West,Alabama,1993,N,N
12,2,0,10,Pac-10,,Arizona,1993,N,N
11,5,0,6,Pac-10,,Arizona State,1993,N,N
11,6,0,5,SEC,West,Arkansas,1993,N,N
11,8,0,3,Big West,,Arkansas State,1993,N,N
11,5,0,6,FBS Independents,,Army,1993,N,N
11,0,0,11,SEC,West,Auburn,1993,N,N
12,4,0,8,Mid-American,,Ball State,1993,N,N
11,6,0,5,Southwest,,Baylor,1993,N,N
12,3,0,9,Big East,,Boston College,1993,N,N
11,4,0,7,Mid-American,,Bowling Green,1993,N,N
12,6,0,6,Western Athletic,,BYU,1993,N,N
13,4,0,9,Pac-10,,California,1993,N,N
11,6,0,5,Mid-American,,Central Michigan,1993,N,N
11,3,0,8,FBS Independents,,Cincinnati,1993,N,N
12,3,0,9,ACC,,Clemson,1993,N,N
12,3,0,9,Big 8,,Colorado,1993,N,N
11,6,0,5,Western Athletic,,Colorado State,1993,N,N
11,8,0,3,ACC,,Duke,1993,N,N
11,9,0,2,FBS Independents,,East Carolina,1993,N,N
11,7,0,4,Mid-American,,Eastern Michigan,1993,N,N
13,2,0,11,SEC,East,Florida,1993,N,N
13,1,0,12,ACC,,Florida State,1993,Y,N
12,4,0,8,Western Athletic,,Fresno State,1993,N,N
11,6,0,5,SEC,East,Georgia,1993,N,N
11,6,0,5,ACC,,Georgia Tech,1993,N,N
12,6,0,6,Western Athletic,,Hawai'i,1993,N,N
11,10,0,1,Southwest,,Houston,1993,N,N
11,6,0,5,Big Ten,,Illinois,1993,N,N
12,4,0,8,Big Ten,,Indiana,1993,N,N
12,6,0,6,Big Ten,,Iowa,1993,N,N
11,8,0,3,Big 8,,Iowa State,1993,N,N
12,7,0,5,Big 8,,Kansas,1993,N,N
12,3,0,9,Big 8,,Kansas State,1993,N,N
11,11,0,0,Mid-American,,Kent State,1993,N,N
12,6,0,6,SEC,East,Kentucky,1993,N,N
11,3,0,8,Big West,,Louisiana,1993,N,N
11,9,0,2,Big West,,Louisiana Tech,1993,N,N
12,3,0,9,FBS Independents,,Louisville,1993,N,N
11,6,0,5,SEC,West,LSU,1993,N,N
11,9,0,2,ACC,,Maryland,1993,N,N
11,5,0,6,FBS Independents,,Memphis,1993,N,N
12,3,0,9,Big East,,Miami,1993,N,N
11,7,0,4,Mid-American,,Miami (OH),1993,N,N
12,4,0,8,Big Ten,,Michigan,1993,N,N
12,6,0,6,Big Ten,,Michigan State,1993,N,N
11,7,0,4,Big Ten,,Minnesota,1993,N,N
11,7,0,4,SEC,West,Mississippi State,1993,N,N
11,8,0,3,Big 8,,Missouri,1993,N,N
11,7,0,4,FBS Independents,,Navy,1993,N,N
12,5,0,7,ACC,,NC State,1993,N,N
12,1,0,11,Big 8,,Nebraska,1993,N,N
11,4,0,7,Big West,,Nevada,1993,N,N
11,5,0,6,Western Athletic,,New Mexico,1993,N,N
11,6,0,5,Big West,,New Mexico State,1993,N,N
13,3,0,10,ACC,,North Carolina,1993,N,N
11,7,0,4,Big West,,Northern Illinois,1993,N,N
11,9,0,2,Big Ten,,Northwestern,1993,N,N
12,1,0,11,FBS Independents,,Notre Dame,1993,N,N
11,7,0,4,Mid-American,,Ohio,1993,N,N
12,1,0,11,Big Ten,,Ohio State,1993,N,N
12,3,0,9,Big 8,,Oklahoma,1993,N,N
11,8,0,3,Big 8,,Oklahoma State,1993,N,N
11,6,0,5,SEC,West,Ole Miss,1993,N,N
11,6,0,5,Pac-10,,Oregon,1993,N,N
11,7,0,4,Pac-10,,Oregon State,1993,N,N
11,8,0,3,Big West,,Pacific,1993,N,N
12,2,0,10,Big Ten,,Penn State,1993,N,N
11,8,0,3,Big East,,Pittsburgh,1993,N,N
11,10,0,1,Big Ten,,Purdue,1993,N,N
11,5,0,6,Southwest,,Rice,1993,N,N
11,7,0,4,Big East,,Rutgers,1993,N,N
12,6,0,6,Western Athletic,,San Diego State,1993,N,N
11,9,0,2,Big West,,San Josï¿½ State,1993,N,N
11,7,0,4,Southwest,,SMU,1993,N,N
11,7,0,4,SEC,East,South Carolina,1993,N,N
11,8,0,3,FBS Independents,,Southern Mississippi,1993,N,N
11,7,0,4,Pac-10,,Stanford,1993,N,N
11,4,0,7,Big East,,Syracuse,1993,N,N
11,7,0,4,Southwest,,TCU,1993,N,N
11,10,0,1,Big East,,Temple,1993,N,N
12,2,0,10,SEC,East,Tennessee,1993,N,N
11,6,0,5,Southwest,,Texas,1993,N,N
12,2,0,10,Southwest,,Texas A&M,1993,N,N
12,6,0,6,Southwest,,Texas Tech,1993,N,N
11,7,0,4,Mid-American,,Toledo,1993,N,N
12,9,0,3,FBS Independents,,Tulane,1993,N,N
11,7,0,4,FBS Independents,,Tulsa,1993,N,N
12,4,0,8,Pac-10,,UCLA,1993,N,N
11,8,0,3,Big West,,UNLV,1993,N,N
13,5,0,8,Pac-10,,USC,1993,N,N
13,6,0,7,Western Athletic,,Utah,1993,N,N
12,5,0,7,Big West,,Utah State,1993,N,N
12,11,0,1,Western Athletic,,UTEP,1993,N,N
11,7,0,4,SEC,East,Vanderbilt,1993,N,N
12,5,0,7,ACC,,Virginia,1993,N,N
12,3,0,9,Big East,,Virginia Tech,1993,N,N
11,9,0,2,ACC,,Wake Forest,1993,N,N
11,4,0,7,Pac-10,,Washington,1993,N,N
11,6,0,5,Pac-10,,Washington State,1993,N,N
11,3,0,8,Mid-American,,Western Michigan,1993,N,N
12,1,0,11,Big East,,West Virginia,1993,N,N
12,2,0,10,Big Ten,,Wisconsin,1993,N,N
12,4,0,8,Western Athletic,,Wyoming,1993,N,N
12,4,0,8,Western Athletic,,Air Force,1994,N,N
11,10,0,1,Mid-American,,Akron,1994,N,N
13,1,0,12,SEC,West,Alabama,1994,N,N
12,4,0,8,Pac-10,,Arizona,1994,N,N
11,8,0,3,Pac-10,,Arizona State,1994,N,N
11,7,0,4,SEC,West,Arkansas,1994,N,N
11,10,0,1,Big West,,Arkansas State,1994,N,N
11,7,0,4,FBS Independents,,Army,1994,N,N
11,2,0,9,SEC,West,Auburn,1994,N,N
11,5,0,6,Mid-American,,Ball State,1994,N,N
12,5,0,7,Southwest,,Baylor,1994,N,N
12,5,0,7,Big East,,Boston College,1994,N,N
11,2,0,9,Mid-American,,Bowling Green,1994,N,N
13,3,0,10,Western Athletic,,BYU,1994,N,N
11,7,0,4,Pac-10,,California,1994,N,N
12,3,0,9,Mid-American,,Central Michigan,1994,N,N
11,8,0,3,FBS Independents,,Cincinnati,1994,N,N
11,6,0,5,ACC,,Clemson,1994,N,N
12,1,0,11,Big 8,,Colorado,1994,N,N
12,2,0,10,Western Athletic,,Colorado State,1994,N,N
12,4,0,8,ACC,,Duke,1994,N,N
12,5,0,7,FBS Independents,,East Carolina,1994,N,N
11,6,0,5,Mid-American,,Eastern Michigan,1994,N,N
13,2,0,11,SEC,East,Florida,1994,N,N
12,2,0,10,ACC,,Florida State,1994,N,N
13,7,0,6,Western Athletic,,Fresno State,1994,N,N
11,4,0,7,SEC,East,Georgia,1994,N,N
11,10,0,1,ACC,,Georgia Tech,1994,N,N
12,9,0,3,Western Athletic,,Hawai'i,1994,N,N
11,10,0,1,Southwest,,Houston,1994,N,N
12,5,0,7,Big Ten,,Illinois,1994,N,N
11,5,0,6,Big Ten,,Indiana,1994,N,N
11,5,0,6,Big Ten,,Iowa,1994,N,N
11,10,0,1,Big 8,,Iowa State,1994,N,N
11,5,0,6,Big 8,,Kansas,1994,N,N
12,3,0,9,Big 8,,Kansas State,1994,N,N
11,9,0,2,Mid-American,,Kent State,1994,N,N
11,10,0,1,SEC,East,Kentucky,1994,N,N
11,5,0,6,Big West,,Louisiana,1994,N,N
11,8,0,3,FBS Independents,,Louisiana Monroe,1994,N,N
11,8,0,3,Big West,,Louisiana Tech,1994,N,N
11,5,0,6,FBS Independents,,Louisville,1994,N,N
11,7,0,4,SEC,West,LSU,1994,N,N
11,7,0,4,ACC,,Maryland,1994,N,N
11,5,0,6,FBS Independents,,Memphis,1994,N,N
12,2,0,10,Big East,,Miami,1994,N,N
11,6,0,5,Mid-American,,Miami (OH),1994,N,N
12,4,0,8,Big Ten,,Michigan,1994,N,N
11,6,0,5,Big Ten,,Michigan State,1994,N,N
11,8,0,3,Big Ten,,Minnesota,1994,N,N
12,4,0,8,SEC,West,Mississippi State,1994,N,N
12,8,0,4,Big 8,,Missouri,1994,N,N
11,8,0,3,FBS Independents,,Navy,1994,N,N
12,3,0,9,ACC,,NC State,1994,N,N
13,0,0,13,Big 8,,Nebraska,1994,Y,N
11,2,0,9,Big West,,Nevada,1994,N,N
12,7,0,5,Western Athletic,,New Mexico,1994,N,N
11,8,0,3,Big West,,New Mexico State,1994,N,N
12,4,0,8,ACC,,North Carolina,1994,N,N
11,7,0,4,Big West,,Northern Illinois,1994,N,N
11,8,0,3,Big Ten,,Northwestern,1994,N,N
12,5,0,7,FBS Independents,,Notre Dame,1994,N,N
11,11,0,0,Mid-American,,Ohio,1994,N,N
13,4,0,9,Big Ten,,Ohio State,1994,N,N
12,6,0,6,Big 8,,Oklahoma,1994,N,N
11,8,0,3,Big 8,,Oklahoma State,1994,N,N
11,7,0,4,SEC,West,Ole Miss,1994,N,N
13,4,0,9,Pac-10,,Oregon,1994,N,N
11,7,0,4,Pac-10,,Oregon State,1994,N,N
11,5,0,6,Big West,,Pacific,1994,N,N
12,0,0,12,Big Ten,,Penn State,1994,N,N
11,8,0,3,Big East,,Pittsburgh,1994,N,N
11,6,0,5,Big Ten,,Purdue,1994,N,N
11,6,0,5,Southwest,,Rice,1994,N,N
11,5,0,6,Big East,,Rutgers,1994,N,N
11,7,0,4,Western Athletic,,San Diego State,1994,N,N
11,8,0,3,Big West,,San Josï¿½ State,1994,N,N
11,10,0,1,Southwest,,SMU,1994,N,N
12,5,0,7,SEC,East,South Carolina,1994,N,N
11,5,0,6,FBS Independents,,Southern Mississippi,1994,N,N
11,7,0,4,Pac-10,,Stanford,1994,N,N
11,4,0,7,Big East,,Syracuse,1994,N,N
12,5,0,7,Southwest,,TCU,1994,N,N
11,9,0,2,Big East,,Temple,1994,N,N
12,4,0,8,SEC,East,Tennessee,1994,N,N
12,4,0,8,Southwest,,Texas,1994,N,N
11,0,0,11,Southwest,,Texas A&M,1994,N,N
12,6,0,6,Southwest,,Texas Tech,1994,N,N
11,5,0,6,Mid-American,,Toledo,1994,N,N
11,10,0,1,FBS Independents,,Tulane,1994,N,N
11,8,0,3,FBS Independents,,Tulsa,1994,N,N
11,6,0,5,Pac-10,,UCLA,1994,N,N
12,5,0,7,Big West,,UNLV,1994,N,N
12,4,0,8,Pac-10,,USC,1994,N,N
12,2,0,10,Western Athletic,,Utah,1994,N,N
11,8,0,3,Big West,,Utah State,1994,N,N
11,8,0,3,Western Athletic,,UTEP,1994,N,N
11,6,0,5,SEC,East,Vanderbilt,1994,N,N
12,3,0,9,ACC,,Virginia,1994,N,N
12,4,0,8,Big East,,Virginia Tech,1994,N,N
11,8,0,3,ACC,,Wake Forest,1994,N,N
11,4,0,7,Pac-10,,Washington,1994,N,N
12,4,0,8,Pac-10,,Washington State,1994,N,N
11,4,0,7,Mid-American,,Western Michigan,1994,N,N
13,6,0,7,Big East,,West Virginia,1994,N,N
12,5,0,7,Big Ten,,Wisconsin,1994,N,N
12,6,0,6,Western Athletic,,Wyoming,1994,N,N
13,5,0,8,Western Athletic,,Air Force,1995,N,N
11,9,0,2,Mid-American,,Akron,1995,N,N
11,3,0,8,SEC,West,Alabama,1995,N,N
11,5,0,6,Pac-10,,Arizona,1995,N,N
11,5,0,6,Pac-10,,Arizona State,1995,N,N
13,5,0,8,SEC,West,Arkansas,1995,N,N
11,5,0,6,Big West,,Arkansas State,1995,N,N
11,6,0,5,FBS Independents,,Army,1995,N,N
12,4,0,8,SEC,West,Auburn,1995,N,N
11,4,0,7,Mid-American,,Ball State,1995,N,N
11,4,0,7,Southwest,,Baylor,1995,N,N
12,8,0,4,Big East,,Boston College,1995,N,N
11,6,0,5,Mid-American,,Bowling Green,1995,N,N
11,4,0,7,Western Athletic,,BYU,1995,N,N
11,8,0,3,Pac-10,,California,1995,N,N
11,7,0,4,Mid-American,,Central Michigan,1995,N,N
11,5,0,6,FBS Independents,,Cincinnati,1995,N,N
12,4,0,8,ACC,,Clemson,1995,N,N
12,2,0,10,Big 8,,Colorado,1995,N,N
12,4,0,8,Western Athletic,,Colorado State,1995,N,N
11,8,0,3,ACC,,Duke,1995,N,N
12,3,0,9,FBS Independents,,East Carolina,1995,N,N
11,5,0,6,Mid-American,,Eastern Michigan,1995,N,N
13,1,0,12,SEC,East,Florida,1995,N,N
12,2,0,10,ACC,,Florida State,1995,N,N
12,7,0,5,Western Athletic,,Fresno State,1995,N,N
12,6,0,6,SEC,East,Georgia,1995,N,N
11,5,0,6,ACC,,Georgia Tech,1995,N,N
12,8,0,4,Western Athletic,,Hawai'i,1995,N,N
11,9,0,2,Southwest,,Houston,1995,N,N
11,5,0,6,Big Ten,,Illinois,1995,N,N
11,9,0,2,Big Ten,,Indiana,1995,N,N
12,4,0,8,Big Ten,,Iowa,1995,N,N
11,8,0,3,Big 8,,Iowa State,1995,N,N
12,2,0,10,Big 8,,Kansas,1995,N,N
12,2,0,10,Big 8,,Kansas State,1995,N,N
11,9,0,2,Mid-American,,Kent State,1995,N,N
11,7,0,4,SEC,East,Kentucky,1995,N,N
11,5,0,6,Big West,,Louisiana,1995,N,N
11,9,0,2,FBS Independents,,Louisiana Monroe,1995,N,N
11,6,0,5,Big West,,Louisiana Tech,1995,N,N
11,4,0,7,FBS Independents,,Louisville,1995,N,N
12,4,0,8,SEC,West,LSU,1995,N,N
11,5,0,6,ACC,,Maryland,1995,N,N
11,8,0,3,FBS Independents,,Memphis,1995,N,N
11,3,0,8,Big East,,Miami,1995,N,N
11,3,0,8,Mid-American,,Miami (OH),1995,N,N
13,4,0,9,Big Ten,,Michigan,1995,N,N
12,5,0,7,Big Ten,,Michigan State,1995,N,N
11,8,0,3,Big Ten,,Minnesota,1995,N,N
11,8,0,3,SEC,West,Mississippi State,1995,N,N
11,8,0,3,Big 8,,Missouri,1995,N,N
11,6,0,5,FBS Independents,,Navy,1995,N,N
11,8,0,3,ACC,,NC State,1995,N,N
12,0,0,12,Big 8,,Nebraska,1995,Y,N
12,3,0,9,Big West,,Nevada,1995,N,N
11,7,0,4,Western Athletic,,New Mexico,1995,N,N
11,7,0,4,Big West,,New Mexico State,1995,N,N
12,5,0,7,ACC,,North Carolina,1995,N,N
11,8,0,3,Big West,,Northern Illinois,1995,N,N
11,9,0,2,FBS Independents,,North Texas,1995,N,N
12,2,0,10,Big Ten,,Northwestern,1995,N,N
12,3,0,9,FBS Independents,,Notre Dame,1995,N,N
11,9,0,2,Mid-American,,Ohio,1995,N,N
13,2,0,11,Big Ten,,Ohio State,1995,N,N
11,6,0,5,Big 8,,Oklahoma,1995,N,N
12,8,0,4,Big 8,,Oklahoma State,1995,N,N
11,5,0,6,SEC,West,Ole Miss,1995,N,N
12,3,0,9,Pac-10,,Oregon,1995,N,N
11,10,0,1,Pac-10,,Oregon State,1995,N,N
11,8,0,3,Big West,,Pacific,1995,N,N
12,3,0,9,Big Ten,,Penn State,1995,N,N
11,9,0,2,Big East,,Pittsburgh,1995,N,N
11,7,0,4,Big Ten,,Purdue,1995,N,N
11,8,0,3,Southwest,,Rice,1995,N,N
11,7,0,4,Big East,,Rutgers,1995,N,N
12,4,0,8,Western Athletic,,San Diego State,1995,N,N
11,8,0,3,Big West,,San Josï¿½ State,1995,N,N
11,10,0,1,Southwest,,SMU,1995,N,N
11,7,0,4,SEC,East,South Carolina,1995,N,N
11,5,0,6,FBS Independents,,Southern Mississippi,1995,N,N
12,5,0,7,Pac-10,,Stanford,1995,N,N
12,3,0,9,Big East,,Syracuse,1995,N,N
11,5,0,6,Southwest,,TCU,1995,N,N
11,10,0,1,Big East,,Temple,1995,N,N
12,1,0,11,SEC,East,Tennessee,1995,N,N
13,2,0,11,Southwest,,Texas,1995,N,N
12,3,0,9,Southwest,,Texas A&M,1995,N,N
12,3,0,9,Southwest,,Texas Tech,1995,N,N
12,0,0,12,Mid-American,,Toledo,1995,N,N
11,9,0,2,FBS Independents,,Tulane,1995,N,N
11,7,0,4,FBS Independents,,Tulsa,1995,N,N
12,5,0,7,Pac-10,,UCLA,1995,N,N
11,9,0,2,Big West,,UNLV,1995,N,N
12,2,0,10,Pac-10,,USC,1995,N,N
11,4,0,7,Western Athletic,,Utah,1995,N,N
11,7,0,4,Big West,,Utah State,1995,N,N
12,10,0,2,Western Athletic,,UTEP,1995,N,N
11,9,0,2,SEC,East,Vanderbilt,1995,N,N
13,4,0,9,ACC,,Virginia,1995,N,N
12,2,0,10,Big East,,Virginia Tech,1995,N,N
11,10,0,1,ACC,,Wake Forest,1995,N,N
12,5,0,7,Pac-10,,Washington,1995,N,N
11,8,0,3,Pac-10,,Washington State,1995,N,N
11,4,0,7,Mid-American,,Western Michigan,1995,N,N
11,6,0,5,Big East,,West Virginia,1995,N,N
11,6,0,5,Big Ten,,Wisconsin,1995,N,N
11,5,0,6,Western Athletic,,Wyoming,1995,N,N
11,5,0,6,Western Athletic,Pacific,Air Force,1996,N,N
11,7,0,4,Mid-American,,Akron,1996,N,N
13,3,0,10,SEC,West,Alabama,1996,N,N
11,6,0,5,Pac-10,,Arizona,1996,N,N
12,1,0,11,Pac-10,,Arizona State,1996,N,N
11,7,0,4,SEC,West,Arkansas,1996,N,N
11,7,0,4,FBS Independents,,Arkansas State,1996,N,N
12,2,0,10,FBS Independents,,Army,1996,N,N
12,4,0,8,SEC,West,Auburn,1996,N,N
12,4,0,8,Mid-American,,Ball State,1996,N,N
11,7,0,4,Big 12,South,Baylor,1996,N,N
12,10,0,2,Big West,,Boise State,1996,N,N
12,7,0,5,Big East,,Boston College,1996,N,N
11,7,0,4,Mid-American,,Bowling Green,1996,N,N
15,1,0,14,Western Athletic,Mountain,BYU,1996,N,N
12,6,0,6,Pac-10,,California,1996,N,N
11,6,0,5,Mid-American,,Central Michigan,1996,N,N
11,5,0,6,Conference USA,,Cincinnati,1996,N,N
12,5,0,7,ACC,,Clemson,1996,N,N
12,2,0,10,Big 12,North,Colorado,1996,N,N
12,5,0,7,Western Athletic,Pacific,Colorado State,1996,N,N
11,11,0,0,ACC,,Duke,1996,N,N
11,3,0,8,FBS Independents,,East Carolina,1996,N,N
11,8,0,3,Mid-American,,Eastern Michigan,1996,N,N
13,1,0,12,SEC,East,Florida,1996,Y,N
12,1,0,11,ACC,,Florida State,1996,N,N
11,7,0,4,Western Athletic,Pacific,Fresno State,1996,N,N
11,6,0,5,SEC,East,Georgia,1996,N,N
11,6,0,5,ACC,,Georgia Tech,1996,N,N
12,10,0,2,Western Athletic,Pacific,Hawai'i,1996,N,N
12,5,0,7,Conference USA,,Houston,1996,N,N
11,5,0,6,Big West,,Idaho,1996,N,N
11,9,0,2,Big Ten,,Illinois,1996,N,N
11,8,0,3,Big Ten,,Indiana,1996,N,N
12,3,0,9,Big Ten,,Iowa,1996,N,N
11,9,0,2,Big 12,North,Iowa State,1996,N,N
11,7,0,4,Big 12,North,Kansas,1996,N,N
12,3,0,9,Big 12,North,Kansas State,1996,N,N
11,9,0,2,Mid-American,,Kent State,1996,N,N
11,7,0,4,SEC,East,Kentucky,1996,N,N
11,6,0,5,FBS Independents,,Louisiana,1996,N,N
11,6,0,5,FBS Independents,,Louisiana Monroe,1996,N,N
11,5,0,6,FBS Independents,,Louisiana Tech,1996,N,N
11,6,0,5,Conference USA,,Louisville,1996,N,N
12,2,0,10,SEC,West,LSU,1996,N,N
11,6,0,5,ACC,,Maryland,1996,N,N
11,7,0,4,Conference USA,,Memphis,1996,N,N
12,3,0,9,Big East,,Miami,1996,N,N
11,5,0,6,Mid-American,,Miami (OH),1996,N,N
12,4,0,8,Big Ten,,Michigan,1996,N,N
12,6,0,6,Big Ten,,Michigan State,1996,N,N
11,7,0,4,Big Ten,,Minnesota,1996,N,N
11,6,0,5,SEC,West,Mississippi State,1996,N,N
11,6,0,5,Big 12,North,Missouri,1996,N,N
12,3,0,9,FBS Independents,,Navy,1996,N,N
11,8,0,3,ACC,,NC State,1996,N,N
13,2,0,11,Big 12,North,Nebraska,1996,N,N
12,3,0,9,Big West,,Nevada,1996,N,N
11,5,0,6,Western Athletic,Mountain,New Mexico,1996,N,N
11,10,0,1,Big West,,New Mexico State,1996,N,N
12,2,0,10,ACC,,North Carolina,1996,N,N
11,10,0,1,FBS Independents,,Northern Illinois,1996,N,N
11,6,0,5,Big West,,North Texas,1996,N,N
12,3,0,9,Big Ten,,Northwestern,1996,N,N
11,3,0,8,FBS Independents,,Notre Dame,1996,N,N
12,6,0,6,Mid-American,,Ohio,1996,N,N
12,1,0,11,Big Ten,,Ohio State,1996,N,N
11,8,0,3,Big 12,South,Oklahoma,1996,N,N
11,6,0,5,Big 12,South,Oklahoma State,1996,N,N
11,6,0,5,SEC,West,Ole Miss,1996,N,N
11,5,0,6,Pac-10,,Oregon,1996,N,N
11,9,0,2,Pac-10,,Oregon State,1996,N,N
13,2,0,11,Big Ten,,Penn State,1996,N,N
11,7,0,4,Big East,,Pittsburgh,1996,N,N
11,8,0,3,Big Ten,,Purdue,1996,N,N
11,4,0,7,Western Athletic,Mountain,Rice,1996,N,N
11,9,0,2,Big East,,Rutgers,1996,N,N
11,3,0,8,Western Athletic,Pacific,San Diego State,1996,N,N
12,9,0,3,Western Athletic,Pacific,San Josï¿½ State,1996,N,N
11,6,0,5,Western Athletic,Mountain,SMU,1996,N,N
11,5,0,6,SEC,East,South Carolina,1996,N,N
11,3,0,8,Conference USA,,Southern Mississippi,1996,N,N
12,5,0,7,Pac-10,,Stanford,1996,N,N
12,3,0,9,Big East,,Syracuse,1996,N,N
11,7,0,4,Western Athletic,Mountain,TCU,1996,N,N
11,10,0,1,Big East,,Temple,1996,N,N
12,2,0,10,SEC,East,Tennessee,1996,N,N
13,5,0,8,Big 12,South,Texas,1996,N,N
12,6,0,6,Big 12,South,Texas A&M,1996,N,N
12,5,0,7,Big 12,South,Texas Tech,1996,N,N
11,4,0,7,Mid-American,,Toledo,1996,N,N
11,9,0,2,Conference USA,,Tulane,1996,N,N
11,7,0,4,Western Athletic,Mountain,Tulsa,1996,N,N
11,6,0,5,FBS Independents,,UAB,1996,N,N
11,6,0,5,FBS Independents,,UCF,1996,N,N
11,6,0,5,Pac-10,,UCLA,1996,N,N
12,11,0,1,Western Athletic,Pacific,UNLV,1996,N,N
12,6,0,6,Pac-10,,USC,1996,N,N
11,5,0,6,Big West,,Utah State,1996,N,N
11,9,0,2,Western Athletic,Mountain,UTEP,1996,N,N
11,9,0,2,SEC,East,Vanderbilt,1996,N,N
12,5,0,7,ACC,,Virginia,1996,N,N
12,2,0,10,Big East,,Virginia Tech,1996,N,N
11,8,0,3,ACC,,Wake Forest,1996,N,N
12,3,0,9,Pac-10,,Washington,1996,N,N
11,6,0,5,Pac-10,,Washington State,1996,N,N
11,9,0,2,Mid-American,,Western Michigan,1996,N,N
12,4,0,8,Big East,,West Virginia,1996,N,N
13,5,0,8,Big Ten,,Wisconsin,1996,N,N
12,2,0,10,Western Athletic,Pacific,Wyoming,1996,N,N
13,3,0,10,Western Athletic,Pacific,Air Force,1997,N,N
11,9,0,2,Mid-American,East,Akron,1997,N,N
11,7,0,4,SEC,West,Alabama,1997,N,N
12,5,0,7,Pac-10,,Arizona,1997,N,N
12,3,0,9,Pac-10,,Arizona State,1997,N,N
11,7,0,4,SEC,West,Arkansas,1997,N,N
11,9,0,2,FBS Independents,,Arkansas State,1997,N,N
11,7,0,4,FBS Independents,,Army,1997,N,N
13,3,0,10,SEC,West,Auburn,1997,N,N
11,6,0,5,Mid-American,West,Ball State,1997,N,N
11,9,0,2,Big 12,South,Baylor,1997,N,N
11,7,0,4,Big West,,Boise State,1997,N,N
11,7,0,4,Big East,,Boston College,1997,N,N
11,8,0,3,Mid-American,East,Bowling Green,1997,N,N
11,5,0,6,Western Athletic,Mountain,BYU,1997,N,N
11,8,0,3,Pac-10,,California,1997,N,N
11,9,0,2,Mid-American,West,Central Michigan,1997,N,N
12,4,0,8,Conference USA,,Cincinnati,1997,N,N
12,5,0,7,ACC,,Clemson,1997,N,N
11,6,0,5,Big 12,North,Colorado,1997,N,N
13,2,0,11,Western Athletic,Pacific,Colorado State,1997,N,N
11,9,0,2,ACC,,Duke,1997,N,N
11,6,0,5,Conference USA,,East Carolina,1997,N,N
11,7,0,4,Mid-American,West,Eastern Michigan,1997,N,N
12,2,0,10,SEC,East,Florida,1997,N,N
12,1,0,11,ACC,,Florida State,1997,N,N
12,6,0,6,Western Athletic,Pacific,Fresno State,1997,N,N
12,2,0,10,SEC,East,Georgia,1997,N,N
12,5,0,7,ACC,,Georgia Tech,1997,N,N
12,9,0,3,Western Athletic,Pacific,Hawai'i,1997,N,N
11,8,0,3,Conference USA,,Houston,1997,N,N
11,6,0,5,Big West,,Idaho,1997,N,N
11,11,0,0,Big Ten,,Illinois,1997,N,N
11,9,0,2,Big Ten,,Indiana,1997,N,N
12,5,0,7,Big Ten,,Iowa,1997,N,N
11,10,0,1,Big 12,North,Iowa State,1997,N,N
11,6,0,5,Big 12,North,Kansas,1997,N,N
12,1,0,11,Big 12,North,Kansas State,1997,N,N
11,8,0,3,Mid-American,East,Kent State,1997,N,N
11,6,0,5,SEC,East,Kentucky,1997,N,N
11,10,0,1,FBS Independents,,Louisiana,1997,N,N
12,7,0,5,FBS Independents,,Louisiana Monroe,1997,N,N
11,2,0,9,FBS Independents,,Louisiana Tech,1997,N,N
11,10,0,1,Conference USA,,Louisville,1997,N,N
12,3,0,9,SEC,West,LSU,1997,N,N
13,3,0,10,Mid-American,East,Marshall,1997,N,N
11,9,0,2,ACC,,Maryland,1997,N,N
11,7,0,4,Conference USA,,Memphis,1997,N,N
11,6,0,5,Big East,,Miami,1997,N,N
11,3,0,8,Mid-American,East,Miami (OH),1997,N,N
12,0,0,12,Big Ten,,Michigan,1997,Y,N
12,5,0,7,Big Ten,,Michigan State,1997,N,N
12,9,0,3,Big Ten,,Minnesota,1997,N,N
11,4,0,7,SEC,West,Mississippi State,1997,N,N
12,5,0,7,Big 12,North,Missouri,1997,N,N
11,4,0,7,FBS Independents,,Navy,1997,N,N
11,5,0,6,ACC,,NC State,1997,N,N
13,0,0,13,Big 12,North,Nebraska,1997,Y,N
11,6,0,5,Big West,,Nevada,1997,N,N
13,4,0,9,Western Athletic,Mountain,New Mexico,1997,N,N
11,9,0,2,Big West,,New Mexico State,1997,N,N
12,1,0,11,ACC,,North Carolina,1997,N,N
11,11,0,0,Mid-American,West,Northern Illinois,1997,N,N
11,7,0,4,Big West,,North Texas,1997,N,N
12,7,0,5,Big Ten,,Northwestern,1997,N,N
13,6,0,7,FBS Independents,,Notre Dame,1997,N,N
11,3,0,8,Mid-American,East,Ohio,1997,N,N
13,3,0,10,Big Ten,,Ohio State,1997,N,N
12,8,0,4,Big 12,South,Oklahoma,1997,N,N
12,4,0,8,Big 12,South,Oklahoma State,1997,N,N
12,4,0,8,SEC,West,Ole Miss,1997,N,N
12,5,0,7,Pac-10,,Oregon,1997,N,N
11,8,0,3,Pac-10,,Oregon State,1997,N,N
12,3,0,9,Big Ten,,Penn State,1997,N,N
12,6,0,6,Big East,,Pittsburgh,1997,N,N
12,3,0,9,Big Ten,,Purdue,1997,N,N
11,4,0,7,Western Athletic,Mountain,Rice,1997,N,N
11,11,0,0,Big East,,Rutgers,1997,N,N
12,7,0,5,Western Athletic,Pacific,San Diego State,1997,N,N
11,7,0,4,Western Athletic,Pacific,San Josï¿½ State,1997,N,N
11,5,0,6,Western Athletic,Mountain,SMU,1997,N,N
11,6,0,5,SEC,East,South Carolina,1997,N,N
12,3,0,9,Conference USA,,Southern Mississippi,1997,N,N
11,6,0,5,Pac-10,,Stanford,1997,N,N
13,4,0,9,Big East,,Syracuse,1997,N,N
11,10,0,1,Western Athletic,Mountain,TCU,1997,N,N
11,8,0,3,Big East,,Temple,1997,N,N
13,2,0,11,SEC,East,Tennessee,1997,N,N
11,7,0,4,Big 12,South,Texas,1997,N,N
13,4,0,9,Big 12,South,Texas A&M,1997,N,N
11,5,0,6,Big 12,South,Texas Tech,1997,N,N
12,3,0,9,Mid-American,West,Toledo,1997,N,N
11,4,0,7,Conference USA,,Tulane,1997,N,N
11,9,0,2,Western Athletic,Mountain,Tulsa,1997,N,N
11,6,0,5,FBS Independents,,UAB,1997,N,N
11,6,0,5,FBS Independents,,UCF,1997,N,N
12,2,0,10,Pac-10,,UCLA,1997,N,N
11,8,0,3,Western Athletic,Pacific,UNLV,1997,N,N
11,5,0,6,Pac-10,,USC,1997,N,N
12,6,0,6,Big West,,Utah State,1997,N,N
11,7,0,4,Western Athletic,Mountain,UTEP,1997,N,N
11,8,0,3,SEC,East,Vanderbilt,1997,N,N
11,4,0,7,ACC,,Virginia,1997,N,N
12,5,0,7,Big East,,Virginia Tech,1997,N,N
11,6,0,5,ACC,,Wake Forest,1997,N,N
12,4,0,8,Pac-10,,Washington,1997,N,N
12,2,0,10,Pac-10,,Washington State,1997,N,N
11,3,0,8,Mid-American,West,Western Michigan,1997,N,N
12,5,0,7,Big East,,West Virginia,1997,N,N
13,5,0,8,Big Ten,,Wisconsin,1997,N,N
13,6,0,7,Western Athletic,Pacific,Wyoming,1997,N,N
13,1,0,12,Western Athletic,Mountain,Air Force,1998,N,N
11,7,0,4,Mid-American,East,Akron,1998,N,N
12,5,0,7,SEC,West,Alabama,1998,N,N
13,1,0,12,Pac-10,,Arizona,1998,N,N
11,6,0,5,Pac-10,,Arizona State,1998,N,N
12,3,0,9,SEC,West,Arkansas,1998,N,N
12,8,0,4,FBS Independents,,Arkansas State,1998,N,N
11,8,0,3,Conference USA,,Army,1998,N,N
11,8,0,3,SEC,West,Auburn,1998,N,N
11,10,0,1,Mid-American,West,Ball State,1998,N,N
11,9,0,2,Big 12,South,Baylor,1998,N,N
11,5,0,6,Big West,,Boise State,1998,N,N
11,7,0,4,Big East,,Boston College,1998,N,N
11,6,0,5,Mid-American,East,Bowling Green,1998,N,N
14,5,0,9,Western Athletic,Pacific,BYU,1998,N,N
11,6,0,5,Pac-10,,California,1998,N,N
11,5,0,6,Mid-American,West,Central Michigan,1998,N,N
11,9,0,2,Conference USA,,Cincinnati,1998,N,N
11,8,0,3,ACC,,Clemson,1998,N,N
12,4,0,8,Big 12,North,Colorado,1998,N,N
12,4,0,8,Western Athletic,Mountain,Colorado State,1998,N,N
11,7,0,4,ACC,,Duke,1998,N,N
11,5,0,6,Conference USA,,East Carolina,1998,N,N
11,8,0,3,Mid-American,West,Eastern Michigan,1998,N,N
12,2,0,10,SEC,East,Florida,1998,N,N
13,2,0,11,ACC,,Florida State,1998,N,Y
11,6,0,5,Western Athletic,Pacific,Fresno State,1998,N,N
12,3,0,9,SEC,East,Georgia,1998,N,N
12,2,0,10,ACC,,Georgia Tech,1998,N,N
12,12,0,0,Western Athletic,Pacific,Hawai'i,1998,N,N
11,8,0,3,Conference USA,,Houston,1998,N,N
12,3,0,9,Big West,,Idaho,1998,N,N
11,8,0,3,Big Ten,,Illinois,1998,N,N
11,7,0,4,Big Ten,,Indiana,1998,N,N
11,8,0,3,Big Ten,,Iowa,1998,N,N
11,8,0,3,Big 12,North,Iowa State,1998,N,N
11,7,0,4,Big 12,North,Kansas,1998,N,N
13,2,0,11,Big 12,North,Kansas State,1998,N,N
11,11,0,0,Mid-American,East,Kent State,1998,N,N
12,5,0,7,SEC,East,Kentucky,1998,N,N
11,9,0,2,FBS Independents,,Louisiana,1998,N,N
11,6,0,5,FBS Independents,,Louisiana Monroe,1998,N,N
12,6,0,6,FBS Independents,,Louisiana Tech,1998,N,N
12,5,0,7,Conference USA,,Louisville,1998,N,N
11,7,0,4,SEC,West,LSU,1998,N,N
13,1,0,12,Mid-American,East,Marshall,1998,N,N
11,8,0,3,ACC,,Maryland,1998,N,N
11,9,0,2,Conference USA,,Memphis,1998,N,N
12,3,0,9,Big East,,Miami,1998,N,N
11,1,0,10,Mid-American,East,Miami (OH),1998,N,N
13,3,0,10,Big Ten,,Michigan,1998,N,N
12,6,0,6,Big Ten,,Michigan State,1998,N,N
11,6,0,5,Big Ten,,Minnesota,1998,N,N
13,5,0,8,SEC,West,Mississippi State,1998,N,N
12,4,0,8,Big 12,North,Missouri,1998,N,N
11,8,0,3,FBS Independents,,Navy,1998,N,N
12,5,0,7,ACC,,NC State,1998,N,N
13,4,0,9,Big 12,North,Nebraska,1998,N,N
11,5,0,6,Big West,,Nevada,1998,N,N
12,9,0,3,Western Athletic,Pacific,New Mexico,1998,N,N
11,8,0,3,Big West,,New Mexico State,1998,N,N
12,5,0,7,ACC,,North Carolina,1998,N,N
11,9,0,2,Mid-American,West,Northern Illinois,1998,N,N
11,8,0,3,Big West,,North Texas,1998,N,N
12,9,0,3,Big Ten,,Northwestern,1998,N,N
12,3,0,9,FBS Independents,,Notre Dame,1998,N,N
11,6,0,5,Mid-American,East,Ohio,1998,N,N
12,1,0,11,Big Ten,,Ohio State,1998,N,N
11,6,0,5,Big 12,South,Oklahoma,1998,N,N
11,6,0,5,Big 12,South,Oklahoma State,1998,N,N
12,5,0,7,SEC,West,Ole Miss,1998,N,N
12,4,0,8,Pac-10,,Oregon,1998,N,N
11,6,0,5,Pac-10,,Oregon State,1998,N,N
12,3,0,9,Big Ten,,Penn State,1998,N,N
11,9,0,2,Big East,,Pittsburgh,1998,N,N
13,4,0,9,Big Ten,,Purdue,1998,N,N
11,6,0,5,Western Athletic,Mountain,Rice,1998,N,N
11,6,0,5,Big East,,Rutgers,1998,N,N
12,5,0,7,Western Athletic,Pacific,San Diego State,1998,N,N
12,8,0,4,Western Athletic,Pacific,San Josï¿½ State,1998,N,N
12,7,0,5,Western Athletic,Mountain,SMU,1998,N,N
11,10,0,1,SEC,East,South Carolina,1998,N,N
12,5,0,7,Conference USA,,Southern Mississippi,1998,N,N
11,8,0,3,Pac-10,,Stanford,1998,N,N
12,4,0,8,Big East,,Syracuse,1998,N,N
12,5,0,7,Western Athletic,Mountain,TCU,1998,N,N
11,9,0,2,Big East,,Temple,1998,N,N
13,0,0,13,SEC,East,Tennessee,1998,Y,N
12,3,0,9,Big 12,South,Texas,1998,N,N
14,3,0,11,Big 12,South,Texas A&M,1998,N,N
12,5,0,7,Big 12,South,Texas Tech,1998,N,N
12,5,0,7,Mid-American,West,Toledo,1998,N,N
12,0,0,12,Conference USA,,Tulane,1998,N,N
11,7,0,4,Western Athletic,Mountain,Tulsa,1998,N,N
11,7,0,4,FBS Independents,,UAB,1998,N,N
11,2,0,9,FBS Independents,,UCF,1998,N,N
12,2,0,10,Pac-10,,UCLA,1998,N,N
11,11,0,0,Western Athletic,Mountain,UNLV,1998,N,N
13,5,0,8,Pac-10,,USC,1998,N,N
11,4,0,7,Western Athletic,Pacific,Utah,1998,N,N
11,8,0,3,Big West,,Utah State,1998,N,N
11,8,0,3,Western Athletic,Pacific,UTEP,1998,N,N
11,9,0,2,SEC,East,Vanderbilt,1998,N,N
12,3,0,9,ACC,,Virginia,1998,N,N
12,3,0,9,Big East,,Virginia Tech,1998,N,N
11,8,0,3,ACC,,Wake Forest,1998,N,N
12,6,0,6,Pac-10,,Washington,1998,N,N
11,8,0,3,Pac-10,,Washington State,1998,N,N
11,4,0,7,Mid-American,West,Western Michigan,1998,N,N
12,4,0,8,Big East,,West Virginia,1998,N,N
12,1,0,11,Big Ten,,Wisconsin,1998,N,N
11,3,0,8,Western Athletic,Mountain,Wyoming,1998,N,N
11,5,0,6,Mountain West,,Air Force,1999,N,N
11,4,0,7,Mid-American,East,Akron,1999,N,N
13,3,0,10,SEC,West,Alabama,1999,N,N
12,6,0,6,Pac-10,,Arizona,1999,N,N
12,6,0,6,Pac-10,,Arizona State,1999,N,N
12,4,0,8,SEC,West,Arkansas,1999,N,N
11,7,0,4,Big West,,Arkansas State,1999,N,N
11,8,0,3,Conference USA,,Army,1999,N,N
11,6,0,5,SEC,West,Auburn,1999,N,N
11,11,0,0,Mid-American,West,Ball State,1999,N,N
11,10,0,1,Big 12,South,Baylor,1999,N,N
13,3,0,10,Big West,,Boise State,1999,N,N
12,4,0,8,Big East,,Boston College,1999,N,N
11,6,0,5,Mid-American,East,Bowling Green,1999,N,N
11,11,0,0,Mid-American,East,Buffalo,1999,N,N
12,4,0,8,Mountain West,,BYU,1999,N,N
11,7,0,4,Pac-10,,California,1999,N,N
11,7,0,4,Mid-American,West,Central Michigan,1999,N,N
11,8,0,3,Conference USA,,Cincinnati,1999,N,N
12,6,0,6,ACC,,Clemson,1999,N,N
12,5,0,7,Big 12,North,Colorado,1999,N,N
12,4,0,8,Mountain West,,Colorado State,1999,N,N
11,8,0,3,ACC,,Duke,1999,N,N
12,3,0,9,Conference USA,,East Carolina,1999,N,N
11,7,0,4,Mid-American,West,Eastern Michigan,1999,N,N
13,4,0,9,SEC,East,Florida,1999,N,N
12,0,0,12,ACC,,Florida State,1999,Y,N
13,5,0,8,Western Athletic,,Fresno State,1999,N,N
12,4,0,8,SEC,East,Georgia,1999,N,N
12,4,0,8,ACC,,Georgia Tech,1999,N,N
13,4,0,9,Western Athletic,,Hawai'i,1999,N,N
11,4,0,7,Conference USA,,Houston,1999,N,N
11,4,0,7,Big West,,Idaho,1999,N,N
12,4,0,8,Big Ten,,Illinois,1999,N,N
11,7,0,4,Big Ten,,Indiana,1999,N,N
11,10,0,1,Big Ten,,Iowa,1999,N,N
11,7,0,4,Big 12,North,Iowa State,1999,N,N
12,7,0,5,Big 12,North,Kansas,1999,N,N
12,1,0,11,Big 12,North,Kansas State,1999,N,N
11,9,0,2,Mid-American,East,Kent State,1999,N,N
12,6,0,6,SEC,East,Kentucky,1999,N,N
11,9,0,2,FBS Independents,,Louisiana,1999,N,N
11,6,0,5,FBS Independents,,Louisiana Monroe,1999,N,N
11,3,0,8,FBS Independents,,Louisiana Tech,1999,N,N
12,5,0,7,Conference USA,,Louisville,1999,N,N
11,8,0,3,SEC,West,LSU,1999,N,N
13,0,0,13,Mid-American,East,Marshall,1999,N,N
11,6,0,5,ACC,,Maryland,1999,N,N
11,6,0,5,Conference USA,,Memphis,1999,N,N
13,4,0,9,Big East,,Miami,1999,N,N
11,4,0,7,Mid-American,East,Miami (OH),1999,N,N
12,2,0,10,Big Ten,,Michigan,1999,N,N
12,2,0,10,Big Ten,,Michigan State,1999,N,N
11,8,0,3,FBS Independents,,Middle Tennessee,1999,N,N
12,4,0,8,Big Ten,,Minnesota,1999,N,N
12,2,0,10,SEC,West,Mississippi State,1999,N,N
11,7,0,4,Big 12,North,Missouri,1999,N,N
12,7,0,5,FBS Independents,,Navy,1999,N,N
12,6,0,6,ACC,,NC State,1999,N,N
13,1,0,12,Big 12,North,Nebraska,1999,N,N
11,8,0,3,Big West,,Nevada,1999,N,N
11,7,0,4,Mountain West,,New Mexico,1999,N,N
11,5,0,6,Big West,,New Mexico State,1999,N,N
11,8,0,3,ACC,,North Carolina,1999,N,N
11,6,0,5,Mid-American,West,Northern Illinois,1999,N,N
11,9,0,2,Big West,,North Texas,1999,N,N
11,8,0,3,Big Ten,,Northwestern,1999,N,N
12,7,0,5,FBS Independents,,Notre Dame,1999,N,N
11,6,0,5,Mid-American,East,Ohio,1999,N,N
12,6,0,6,Big Ten,,Ohio State,1999,N,N
12,5,0,7,Big 12,South,Oklahoma,1999,N,N
11,6,0,5,Big 12,South,Oklahoma State,1999,N,N
12,4,0,8,SEC,West,Ole Miss,1999,N,N
12,3,0,9,Pac-10,,Oregon,1999,N,N
12,5,0,7,Pac-10,,Oregon State,1999,N,N
13,3,0,10,Big Ten,,Penn State,1999,N,N
11,6,0,5,Big East,,Pittsburgh,1999,N,N
12,5,0,7,Big Ten,,Purdue,1999,N,N
11,6,0,5,Western Athletic,,Rice,1999,N,N
11,10,0,1,Big East,,Rutgers,1999,N,N
11,6,0,5,Mountain West,,San Diego State,1999,N,N
10,7,0,3,Western Athletic,,San Josï¿½ State,1999,N,N
10,6,0,4,Western Athletic,,SMU,1999,N,N
11,11,0,0,SEC,East,South Carolina,1999,N,N
12,3,0,9,Conference USA,,Southern Mississippi,1999,N,N
12,4,0,8,Pac-10,,Stanford,1999,N,N
12,5,0,7,Big East,,Syracuse,1999,N,N
12,4,0,8,Western Athletic,,TCU,1999,N,N
11,9,0,2,Big East,,Temple,1999,N,N
12,3,0,9,SEC,East,Tennessee,1999,N,N
14,5,0,9,Big 12,South,Texas,1999,N,N
12,4,0,8,Big 12,South,Texas A&M,1999,N,N
11,5,0,6,Big 12,South,Texas Tech,1999,N,N
11,5,0,6,Mid-American,West,Toledo,1999,N,N
11,8,0,3,Conference USA,,Tulane,1999,N,N
11,9,0,2,Western Athletic,,Tulsa,1999,N,N
11,6,0,5,Conference USA,,UAB,1999,N,N
11,7,0,4,FBS Independents,,UCF,1999,N,N
11,7,0,4,Pac-10,,UCLA,1999,N,N
11,8,0,3,Mountain West,,UNLV,1999,N,N
12,6,0,6,Pac-10,,USC,1999,N,N
12,3,0,9,Mountain West,,Utah,1999,N,N
11,7,0,4,Big West,,Utah State,1999,N,N
12,7,0,5,Western Athletic,,UTEP,1999,N,N
11,6,0,5,SEC,East,Vanderbilt,1999,N,N
12,5,0,7,ACC,,Virginia,1999,N,N
12,1,0,11,Big East,,Virginia Tech,1999,N,Y
12,5,0,7,ACC,,Wake Forest,1999,N,N
12,5,0,7,Pac-10,,Washington,1999,N,N
12,9,0,3,Pac-10,,Washington State,1999,N,N
12,5,0,7,Mid-American,West,Western Michigan,1999,N,N
11,7,0,4,Big East,,West Virginia,1999,N,N
12,2,0,10,Big Ten,,Wisconsin,1999,N,N
11,4,0,7,Mountain West,,Wyoming,1999,N,N
12,3,0,9,Mountain West,,Air Force,2000,N,N
11,5,0,6,Mid-American,East,Akron,2000,N,N
11,8,0,3,SEC,West,Alabama,2000,N,N
11,6,0,5,Pac-10,,Arizona,2000,N,N
12,6,0,6,Pac-10,,Arizona State,2000,N,N
12,6,0,6,SEC,West,Arkansas,2000,N,N
11,10,0,1,Big West,,Arkansas State,2000,N,N
11,10,0,1,Conference USA,,Army,2000,N,N
13,4,0,9,SEC,West,Auburn,2000,N,N
11,6,0,5,Mid-American,West,Ball State,2000,N,N
11,9,0,2,Big 12,South,Baylor,2000,N,N
12,2,0,10,Big West,,Boise State,2000,N,N
12,5,0,7,Big East,,Boston College,2000,N,N
11,9,0,2,Mid-American,East,Bowling Green,2000,N,N
11,9,0,2,Mid-American,East,Buffalo,2000,N,N
12,6,0,6,Mountain West,,BYU,2000,N,N
11,8,0,3,Pac-10,,California,2000,N,N
11,9,0,2,Mid-American,West,Central Michigan,2000,N,N
12,5,0,7,Conference USA,,Cincinnati,2000,N,N
12,3,0,9,ACC,,Clemson,2000,N,N
11,8,0,3,Big 12,North,Colorado,2000,N,N
12,2,0,10,Mountain West,,Colorado State,2000,N,N
11,8,0,3,FBS Independents,,Connecticut,2000,N,N
11,11,0,0,ACC,,Duke,2000,N,N
12,4,0,8,Conference USA,,East Carolina,2000,N,N
11,8,0,3,Mid-American,West,Eastern Michigan,2000,N,N
13,3,0,10,SEC,East,Florida,2000,N,N
13,2,0,11,ACC,,Florida State,2000,N,Y
12,5,0,7,Western Athletic,,Fresno State,2000,N,N
12,4,0,8,SEC,East,Georgia,2000,N,N
12,3,0,9,ACC,,Georgia Tech,2000,N,N
12,9,0,3,Western Athletic,,Hawai'i,2000,N,N
11,8,0,3,Conference USA,,Houston,2000,N,N
11,6,0,5,Big West,,Idaho,2000,N,N
11,6,0,5,Big Ten,,Illinois,2000,N,N
11,8,0,3,Big Ten,,Indiana,2000,N,N
12,9,0,3,Big Ten,,Iowa,2000,N,N
12,3,0,9,Big 12,North,Iowa State,2000,N,N
11,7,0,4,Big 12,North,Kansas,2000,N,N
14,3,0,11,Big 12,North,Kansas State,2000,N,N
11,10,0,1,Mid-American,East,Kent State,2000,N,N
11,9,0,2,SEC,East,Kentucky,2000,N,N
11,10,0,1,FBS Independents,,Louisiana,2000,N,N
11,10,0,1,FBS Independents,,Louisiana Monroe,2000,N,N
12,9,0,3,FBS Independents,,Louisiana Tech,2000,N,N
12,3,0,9,Conference USA,,Louisville,2000,N,N
12,4,0,8,SEC,West,LSU,2000,N,N
13,5,0,8,Mid-American,East,Marshall,2000,N,N
11,6,0,5,ACC,,Maryland,2000,N,N
11,7,0,4,Conference USA,,Memphis,2000,N,N
12,1,0,11,Big East,,Miami,2000,N,N
11,5,0,6,Mid-American,East,Miami (OH),2000,N,N
12,3,0,9,Big Ten,,Michigan,2000,N,N
11,6,0,5,Big Ten,,Michigan State,2000,N,N
11,5,0,6,FBS Independents,,Middle Tennessee,2000,N,N
12,6,0,6,Big Ten,,Minnesota,2000,N,N
12,4,0,8,SEC,West,Mississippi State,2000,N,N
11,8,0,3,Big 12,North,Missouri,2000,N,N
11,10,0,1,FBS Independents,,Navy,2000,N,N
12,4,0,8,ACC,,NC State,2000,N,N
12,2,0,10,Big 12,North,Nebraska,2000,N,N
12,10,0,2,Western Athletic,,Nevada,2000,N,N
12,7,0,5,Mountain West,,New Mexico,2000,N,N
11,8,0,3,Big West,,New Mexico State,2000,N,N
11,5,0,6,ACC,,North Carolina,2000,N,N
11,5,0,6,Mid-American,West,Northern Illinois,2000,N,N
11,8,0,3,Big West,,North Texas,2000,N,N
12,4,0,8,Big Ten,,Northwestern,2000,N,N
12,3,0,9,FBS Independents,,Notre Dame,2000,N,N
11,4,0,7,Mid-American,East,Ohio,2000,N,N
12,4,0,8,Big Ten,,Ohio State,2000,N,N
13,0,0,13,Big 12,South,Oklahoma,2000,Y,N
11,8,0,3,Big 12,South,Oklahoma State,2000,N,N
12,5,0,7,SEC,West,Ole Miss,2000,N,N
12,2,0,10,Pac-10,,Oregon,2000,N,N
12,1,0,11,Pac-10,,Oregon State,2000,N,N
12,7,0,5,Big Ten,,Penn State,2000,N,N
12,5,0,7,Big East,,Pittsburgh,2000,N,N
12,4,0,8,Big Ten,,Purdue,2000,N,N
11,8,0,3,Western Athletic,,Rice,2000,N,N
11,8,0,3,Big East,,Rutgers,2000,N,N
11,8,0,3,Mountain West,,San Diego State,2000,N,N
12,5,0,7,Western Athletic,,San Josï¿½ State,2000,N,N
12,9,0,3,Western Athletic,,SMU,2000,N,N
12,4,0,8,SEC,East,South Carolina,2000,N,N
12,4,0,8,Conference USA,,Southern Mississippi,2000,N,N
11,4,0,7,FBS Independents,,South Florida,2000,N,N
11,6,0,5,Pac-10,,Stanford,2000,N,N
11,5,0,6,Big East,,Syracuse,2000,N,N
12,2,0,10,Western Athletic,,TCU,2000,N,N
11,7,0,4,Big East,,Temple,2000,N,N
12,4,0,8,SEC,East,Tennessee,2000,N,N
12,3,0,9,Big 12,South,Texas,2000,N,N
12,5,0,7,Big 12,South,Texas A&M,2000,N,N
13,6,0,7,Big 12,South,Texas Tech,2000,N,N
11,1,0,10,Mid-American,West,Toledo,2000,N,N
11,5,0,6,Conference USA,,Tulane,2000,N,N
12,7,0,5,Western Athletic,,Tulsa,2000,N,N
11,4,0,7,Conference USA,,UAB,2000,N,N
11,4,0,7,FBS Independents,,UCF,2000,N,N
12,6,0,6,Pac-10,,UCLA,2000,N,N
13,5,0,8,Mountain West,,UNLV,2000,N,N
12,7,0,5,Pac-10,,USC,2000,N,N
11,7,0,4,Mountain West,,Utah,2000,N,N
11,6,0,5,Big West,,Utah State,2000,N,N
12,4,0,8,Western Athletic,,UTEP,2000,N,N
11,8,0,3,SEC,East,Vanderbilt,2000,N,N
12,6,0,6,ACC,,Virginia,2000,N,N
12,1,0,11,Big East,,Virginia Tech,2000,N,N
11,9,0,2,ACC,,Wake Forest,2000,N,N
12,1,0,11,Pac-10,,Washington,2000,N,N
11,7,0,4,Pac-10,,Washington State,2000,N,N
12,3,0,9,Mid-American,West,Western Michigan,2000,N,N
12,5,0,7,Big East,,West Virginia,2000,N,N
13,4,0,9,Big Ten,,Wisconsin,2000,N,N
11,10,0,1,Mountain West,,Wyoming,2000,N,N
12,6,0,6,Mountain West,,Air Force,2001,N,N
11,7,0,4,Mid-American,East,Akron,2001,N,N
12,5,0,7,SEC,West,Alabama,2001,N,N
11,6,0,5,Pac-10,,Arizona,2001,N,N
11,7,0,4,Pac-10,,Arizona State,2001,N,N
12,5,0,7,SEC,West,Arkansas,2001,N,N
11,9,0,2,Sun Belt,East,Arkansas State,2001,N,N
11,8,0,3,Conference USA,,Army,2001,N,N
12,5,0,7,SEC,West,Auburn,2001,N,N
11,6,0,5,Mid-American,West,Ball State,2001,N,N
11,8,0,3,Big 12,South,Baylor,2001,N,N
12,4,0,8,Western Athletic,,Boise State,2001,N,N
12,4,0,8,Big East,,Boston College,2001,N,N
11,3,0,8,Mid-American,East,Bowling Green,2001,N,N
11,8,0,3,Mid-American,East,Buffalo,2001,N,N
14,2,0,12,Mountain West,,BYU,2001,N,N
11,10,0,1,Pac-10,,California,2001,N,N
11,8,0,3,Mid-American,West,Central Michigan,2001,N,N
12,5,0,7,Conference USA,,Cincinnati,2001,N,N
12,5,0,7,ACC,,Clemson,2001,N,N
13,3,0,10,Big 12,North,Colorado,2001,N,N
12,5,0,7,Mountain West,,Colorado State,2001,N,N
11,9,0,2,FBS Independents,,Connecticut,2001,N,N
11,11,0,0,ACC,,Duke,2001,N,N
12,6,0,6,Conference USA,,East Carolina,2001,N,N
11,9,0,2,Mid-American,West,Eastern Michigan,2001,N,N
12,2,0,10,SEC,East,Florida,2001,N,N
12,4,0,8,ACC,,Florida State,2001,N,N
14,3,0,11,Western Athletic,,Fresno State,2001,N,N
12,4,0,8,SEC,East,Georgia,2001,N,N
13,5,0,8,ACC,,Georgia Tech,2001,N,N
12,3,0,9,Western Athletic,,Hawai'i,2001,N,N
11,11,0,0,Conference USA,,Houston,2001,N,N
11,10,0,1,Sun Belt,,Idaho,2001,N,N
12,2,0,10,Big Ten,,Illinois,2001,N,N
11,6,0,5,Big Ten,,Indiana,2001,N,N
12,5,0,7,Big Ten,,Iowa,2001,N,N
12,5,0,7,Big 12,North,Iowa State,2001,N,N
11,8,0,3,Big 12,North,Kansas,2001,N,N
12,6,0,6,Big 12,North,Kansas State,2001,N,N
11,5,0,6,Mid-American,East,Kent State,2001,N,N
11,9,0,2,SEC,East,Kentucky,2001,N,N
11,8,0,3,Sun Belt,East,Louisiana,2001,N,N
11,9,0,2,Sun Belt,East,Louisiana Monroe,2001,N,N
12,5,0,7,Western Athletic,,Louisiana Tech,2001,N,N
13,2,0,11,Conference USA,,Louisville,2001,N,N
13,3,0,10,SEC,West,LSU,2001,N,N
13,2,0,11,Mid-American,East,Marshall,2001,N,N
12,2,0,10,ACC,,Maryland,2001,N,N
11,6,0,5,Conference USA,,Memphis,2001,N,N
12,0,0,12,Big East,,Miami,2001,Y,N
12,5,0,7,Mid-American,East,Miami (OH),2001,N,N
12,4,0,8,Big Ten,,Michigan,2001,N,N
12,5,0,7,Big Ten,,Michigan State,2001,N,N
11,3,0,8,Sun Belt,,Middle Tennessee,2001,N,N
11,7,0,4,Big Ten,,Minnesota,2001,N,N
11,8,0,3,SEC,West,Mississippi State,2001,N,N
11,7,0,4,Big 12,North,Missouri,2001,N,N
10,10,0,0,FBS Independents,,Navy,2001,N,N
12,5,0,7,ACC,,NC State,2001,N,N
13,2,0,11,Big 12,North,Nebraska,2001,N,Y
11,8,0,3,Western Athletic,,Nevada,2001,N,N
11,5,0,6,Mountain West,,New Mexico,2001,N,N
12,7,0,5,Sun Belt,,New Mexico State,2001,N,N
13,5,0,8,ACC,,North Carolina,2001,N,N
11,5,0,6,Mid-American,West,Northern Illinois,2001,N,N
12,7,0,5,Sun Belt,,North Texas,2001,N,N
11,7,0,4,Big Ten,,Northwestern,2001,N,N
11,6,0,5,FBS Independents,,Notre Dame,2001,N,N
11,10,0,1,Mid-American,East,Ohio,2001,N,N
12,5,0,7,Big Ten,,Ohio State,2001,N,N
13,2,0,11,Big 12,South,Oklahoma,2001,N,N
11,7,0,4,Big 12,South,Oklahoma State,2001,N,N
11,4,0,7,SEC,West,Ole Miss,2001,N,N
12,1,0,11,Pac-10,,Oregon,2001,N,N
11,6,0,5,Pac-10,,Oregon State,2001,N,N
11,6,0,5,Big Ten,,Penn State,2001,N,N
12,5,0,7,Big East,,Pittsburgh,2001,N,N
12,6,0,6,Big Ten,,Purdue,2001,N,N
12,4,0,8,Western Athletic,,Rice,2001,N,N
11,9,0,2,Big East,,Rutgers,2001,N,N
11,8,0,3,Mountain West,,San Diego State,2001,N,N
12,9,0,3,Western Athletic,,San Josï¿½ State,2001,N,N
11,7,0,4,Western Athletic,,SMU,2001,N,N
12,3,0,9,SEC,East,South Carolina,2001,N,N
11,5,0,6,Conference USA,,Southern Mississippi,2001,N,N
11,3,0,8,FBS Independents,,South Florida,2001,N,N
12,3,0,9,Pac-10,,Stanford,2001,N,N
13,3,0,10,Big East,,Syracuse,2001,N,N
12,6,0,6,Conference USA,,TCU,2001,N,N
11,7,0,4,Big East,,Temple,2001,N,N
13,2,0,11,SEC,East,Tennessee,2001,N,N
13,2,0,11,Big 12,South,Texas,2001,N,N
12,4,0,8,Big 12,South,Texas A&M,2001,N,N
12,5,0,7,Big 12,South,Texas Tech,2001,N,N
12,2,0,10,Mid-American,West,Toledo,2001,N,N
11,4,0,7,FBS Independents,,Troy,2001,N,N
12,9,0,3,Conference USA,,Tulane,2001,N,N
11,10,0,1,Western Athletic,,Tulsa,2001,N,N
11,5,0,6,Conference USA,,UAB,2001,N,N
11,5,0,6,FBS Independents,,UCF,2001,N,N
11,4,0,7,Pac-10,,UCLA,2001,N,N
11,7,0,4,Mountain West,,UNLV,2001,N,N
12,6,0,6,Pac-10,,USC,2001,N,N
12,4,0,8,Mountain West,,Utah,2001,N,N
11,7,0,4,FBS Independents,,Utah State,2001,N,N
11,9,0,2,Western Athletic,,UTEP,2001,N,N
11,9,0,2,SEC,East,Vanderbilt,2001,N,N
12,7,0,5,ACC,,Virginia,2001,N,N
12,4,0,8,Big East,,Virginia Tech,2001,N,N
11,5,0,6,ACC,,Wake Forest,2001,N,N
12,4,0,8,Pac-10,,Washington,2001,N,N
12,2,0,10,Pac-10,,Washington State,2001,N,N
11,6,0,5,Mid-American,West,Western Michigan,2001,N,N
11,8,0,3,Big East,,West Virginia,2001,N,N
12,7,0,5,Big Ten,,Wisconsin,2001,N,N
11,9,0,2,Mountain West,,Wyoming,2001,N,N
13,5,0,8,Mountain West,,Air Force,2002,N,N
12,8,0,4,Mid-American,East,Akron,2002,N,N
13,3,0,10,SEC,West,Alabama,2002,N,N
12,8,0,4,Pac-10,,Arizona,2002,N,N
14,6,0,8,Pac-10,,Arizona State,2002,N,N
14,5,0,9,SEC,West,Arkansas,2002,N,N
13,7,0,6,Sun Belt,East,Arkansas State,2002,N,N
12,11,0,1,Conference USA,,Army,2002,N,N
13,4,0,9,SEC,West,Auburn,2002,N,N
12,6,0,6,Mid-American,West,Ball State,2002,N,N
12,9,0,3,Big 12,South,Baylor,2002,N,N
13,1,0,12,Western Athletic,,Boise State,2002,N,N
13,4,0,9,Big East,,Boston College,2002,N,N
12,3,0,9,Mid-American,West,Bowling Green,2002,N,N
12,11,0,1,Mid-American,East,Buffalo,2002,N,N
12,7,0,5,Mountain West,,BYU,2002,N,N
12,5,0,7,Pac-10,,California,2002,N,N
12,8,0,4,Mid-American,West,Central Michigan,2002,N,N
14,7,0,7,Conference USA,,Cincinnati,2002,N,N
13,6,0,7,ACC,,Clemson,2002,N,N
14,5,0,9,Big 12,North,Colorado,2002,N,N
14,4,0,10,Mountain West,,Colorado State,2002,N,N
12,6,0,6,FBS Independents,,Connecticut,2002,N,N
12,10,0,2,ACC,,Duke,2002,N,N
12,8,0,4,Conference USA,,East Carolina,2002,N,N
12,9,0,3,Mid-American,West,Eastern Michigan,2002,N,N
13,5,0,8,SEC,East,Florida,2002,N,N
14,5,0,9,ACC,,Florida State,2002,N,N
14,5,0,9,Western Athletic,,Fresno State,2002,N,N
14,1,0,13,SEC,East,Georgia,2002,N,N
13,6,0,7,ACC,,Georgia Tech,2002,N,N
14,4,0,10,Western Athletic,,Hawai'i,2002,N,N
12,7,0,5,Conference USA,,Houston,2002,N,N
12,10,0,2,Sun Belt,,Idaho,2002,N,N
12,7,0,5,Big Ten,,Illinois,2002,N,N
12,9,0,3,Big Ten,,Indiana,2002,N,N
13,2,0,11,Big Ten,,Iowa,2002,N,N
14,7,0,7,Big 12,North,Iowa State,2002,N,N
12,10,0,2,Big 12,North,Kansas,2002,N,N
13,2,0,11,Big 12,North,Kansas State,2002,N,N
12,9,0,3,Mid-American,East,Kent State,2002,N,N
12,5,0,7,SEC,East,Kentucky,2002,N,N
12,9,0,3,Sun Belt,East,Louisiana,2002,N,N
12,9,0,3,Sun Belt,East,Louisiana Monroe,2002,N,N
12,8,0,4,Western Athletic,,Louisiana Tech,2002,N,N
13,6,0,7,Conference USA,,Louisville,2002,N,N
13,5,0,8,SEC,West,LSU,2002,N,N
13,2,0,11,Mid-American,East,Marshall,2002,N,N
14,3,0,11,ACC,,Maryland,2002,N,N
12,9,0,3,Conference USA,,Memphis,2002,N,N
13,1,0,12,Big East,,Miami,2002,N,Y
12,5,0,7,Mid-American,East,Miami (OH),2002,N,N
13,3,0,10,Big Ten,,Michigan,2002,N,N
12,8,0,4,Big Ten,,Michigan State,2002,N,N
12,8,0,4,Sun Belt,,Middle Tennessee,2002,N,N
13,5,0,8,Big Ten,,Minnesota,2002,N,N
12,9,0,3,SEC,West,Mississippi State,2002,N,N
12,7,0,5,Big 12,North,Missouri,2002,N,N
12,10,0,2,FBS Independents,,Navy,2002,N,N
14,3,0,11,ACC,,NC State,2002,N,N
14,7,0,7,Big 12,North,Nebraska,2002,N,N
12,7,0,5,Western Athletic,,Nevada,2002,N,N
14,7,0,7,Mountain West,,New Mexico,2002,N,N
12,5,0,7,Sun Belt,,New Mexico State,2002,N,N
12,9,0,3,ACC,,North Carolina,2002,N,N
12,4,0,8,Mid-American,West,Northern Illinois,2002,N,N
13,5,0,8,Sun Belt,,North Texas,2002,N,N
12,9,0,3,Big Ten,,Northwestern,2002,N,N
13,3,0,10,FBS Independents,,Notre Dame,2002,N,N
12,8,0,4,Mid-American,East,Ohio,2002,N,N
14,0,0,14,Big Ten,,Ohio State,2002,Y,N
14,2,0,12,Big 12,South,Oklahoma,2002,N,N
13,5,0,8,Big 12,South,Oklahoma State,2002,N,N
13,6,0,7,SEC,West,Ole Miss,2002,N,N
13,6,0,7,Pac-10,,Oregon,2002,N,N
13,5,0,8,Pac-10,,Oregon State,2002,N,N
13,4,0,9,Big Ten,,Penn State,2002,N,N
13,4,0,9,Big East,,Pittsburgh,2002,N,N
13,6,0,7,Big Ten,,Purdue,2002,N,N
11,7,0,4,Western Athletic,,Rice,2002,N,N
12,11,0,1,Big East,,Rutgers,2002,N,N
13,9,0,4,Mountain West,,San Diego State,2002,N,N
13,7,0,6,Western Athletic,,San Josï¿½ State,2002,N,N
12,9,0,3,Western Athletic,,SMU,2002,N,N
12,7,0,5,SEC,East,South Carolina,2002,N,N
13,6,0,7,Conference USA,,Southern Mississippi,2002,N,N
11,2,0,9,FBS Independents,,South Florida,2002,N,N
11,9,0,2,Pac-10,,Stanford,2002,N,N
12,8,0,4,Big East,,Syracuse,2002,N,N
12,2,0,10,Conference USA,,TCU,2002,N,N
12,8,0,4,Big East,,Temple,2002,N,N
13,5,0,8,SEC,East,Tennessee,2002,N,N
13,2,0,11,Big 12,South,Texas,2002,N,N
12,6,0,6,Big 12,South,Texas A&M,2002,N,N
14,5,0,9,Big 12,South,Texas Tech,2002,N,N
14,5,0,9,Mid-American,West,Toledo,2002,N,N
12,8,0,4,FBS Independents,,Troy,2002,N,N
13,5,0,8,Conference USA,,Tulane,2002,N,N
12,11,0,1,Western Athletic,,Tulsa,2002,N,N
12,7,0,5,Conference USA,,UAB,2002,N,N
12,5,0,7,Mid-American,East,UCF,2002,N,N
13,5,0,8,Pac-10,,UCLA,2002,N,N
12,7,0,5,Mountain West,,UNLV,2002,N,N
13,2,0,11,Pac-10,,USC,2002,N,N
11,6,0,5,Mountain West,,Utah,2002,N,N
11,7,0,4,FBS Independents,,Utah State,2002,N,N
12,10,0,2,Western Athletic,,UTEP,2002,N,N
12,10,0,2,SEC,East,Vanderbilt,2002,N,N
14,5,0,9,ACC,,Virginia,2002,N,N
14,4,0,10,Big East,,Virginia Tech,2002,N,N
13,6,0,7,ACC,,Wake Forest,2002,N,N
13,6,0,7,Pac-10,,Washington,2002,N,N
13,3,0,10,Pac-10,,Washington State,2002,N,N
12,8,0,4,Mid-American,West,Western Michigan,2002,N,N
13,4,0,9,Big East,,West Virginia,2002,N,N
14,6,0,8,Big Ten,,Wisconsin,2002,N,N
12,10,0,2,Mountain West,,Wyoming,2002,N,N
12,5,0,7,Mountain West,,Air Force,2003,N,N
12,5,0,7,Mid-American,East,Akron,2003,N,N
13,9,0,4,SEC,West,Alabama,2003,N,N
12,10,0,2,Pac-10,,Arizona,2003,N,N
12,7,0,5,Pac-10,,Arizona State,2003,N,N
13,4,0,9,SEC,West,Arkansas,2003,N,N
12,7,0,5,Sun Belt,East,Arkansas State,2003,N,N
13,13,0,0,Conference USA,,Army,2003,N,N
13,5,0,8,SEC,West,Auburn,2003,N,N
12,8,0,4,Mid-American,West,Ball State,2003,N,N
12,9,0,3,Big 12,South,Baylor,2003,N,N
14,1,0,13,Western Athletic,,Boise State,2003,N,N
13,5,0,8,Big East,,Boston College,2003,N,N
14,3,0,11,Mid-American,West,Bowling Green,2003,N,N
12,11,0,1,Mid-American,East,Buffalo,2003,N,N
12,8,0,4,Mountain West,,BYU,2003,N,N
14,6,0,8,Pac-10,,California,2003,N,N
12,9,0,3,Mid-American,West,Central Michigan,2003,N,N
12,7,0,5,Conference USA,,Cincinnati,2003,N,N
13,4,0,9,ACC,,Clemson,2003,N,N
12,7,0,5,Big 12,North,Colorado,2003,N,N
13,6,0,7,Mountain West,,Colorado State,2003,N,N
12,3,0,9,FBS Independents,,Connecticut,2003,N,N
12,8,0,4,ACC,,Duke,2003,N,N
12,11,0,1,Conference USA,,East Carolina,2003,N,N
12,9,0,3,Mid-American,West,Eastern Michigan,2003,N,N
13,5,0,8,SEC,East,Florida,2003,N,N
13,3,0,10,ACC,,Florida State,2003,N,N
14,5,0,9,Western Athletic,,Fresno State,2003,N,N
14,3,0,11,SEC,East,Georgia,2003,N,N
13,6,0,7,ACC,,Georgia Tech,2003,N,N
14,5,0,9,Western Athletic,,Hawai'i,2003,N,N
13,6,0,7,Conference USA,,Houston,2003,N,N
12,9,0,3,Sun Belt,,Idaho,2003,N,N
12,11,0,1,Big Ten,,Illinois,2003,N,N
12,10,0,2,Big Ten,,Indiana,2003,N,N
13,3,0,10,Big Ten,,Iowa,2003,N,N
12,10,0,2,Big 12,North,Iowa State,2003,N,N
13,7,0,6,Big 12,North,Kansas,2003,N,N
15,4,0,11,Big 12,North,Kansas State,2003,N,N
12,7,0,5,Mid-American,East,Kent State,2003,N,N
12,8,0,4,SEC,East,Kentucky,2003,N,N
12,8,0,4,Sun Belt,East,Louisiana,2003,N,N
12,11,0,1,Sun Belt,East,Louisiana Monroe,2003,N,N
12,7,0,5,Western Athletic,,Louisiana Tech,2003,N,N
13,4,0,9,Conference USA,,Louisville,2003,N,N
14,1,0,13,SEC,West,LSU,2003,Y,N
12,4,0,8,Mid-American,East,Marshall,2003,N,N
13,3,0,10,ACC,,Maryland,2003,N,N
13,4,0,9,Conference USA,,Memphis,2003,N,N
13,2,0,11,Big East,,Miami,2003,N,N
14,1,0,13,Mid-American,East,Miami (OH),2003,N,N
13,3,0,10,Big Ten,,Michigan,2003,N,N
13,5,0,8,Big Ten,,Michigan State,2003,N,N
12,8,0,4,Sun Belt,,Middle Tennessee,2003,N,N
13,3,0,10,Big Ten,,Minnesota,2003,N,N
12,10,0,2,SEC,West,Mississippi State,2003,N,N
13,5,0,8,Big 12,North,Missouri,2003,N,N
13,5,0,8,FBS Independents,,Navy,2003,N,N
13,5,0,8,ACC,,NC State,2003,N,N
13,3,0,10,Big 12,North,Nebraska,2003,N,N
12,6,0,6,Western Athletic,,Nevada,2003,N,N
13,5,0,8,Mountain West,,New Mexico,2003,N,N
12,9,0,3,Sun Belt,,New Mexico State,2003,N,N
12,10,0,2,ACC,,North Carolina,2003,N,N
12,2,0,10,Mid-American,West,Northern Illinois,2003,N,N
13,4,0,9,Sun Belt,,North Texas,2003,N,N
13,7,0,6,Big Ten,,Northwestern,2003,N,N
12,7,0,5,FBS Independents,,Notre Dame,2003,N,N
12,10,0,2,Mid-American,East,Ohio,2003,N,N
13,2,0,11,Big Ten,,Ohio State,2003,N,N
14,2,0,12,Big 12,South,Oklahoma,2003,N,Y
13,4,0,9,Big 12,South,Oklahoma State,2003,N,N
13,3,0,10,SEC,West,Ole Miss,2003,N,N
13,5,0,8,Pac-10,,Oregon,2003,N,N
13,5,0,8,Pac-10,,Oregon State,2003,N,N
12,9,0,3,Big Ten,,Penn State,2003,N,N
13,5,0,8,Big East,,Pittsburgh,2003,N,N
13,4,0,9,Big Ten,,Purdue,2003,N,N
12,7,0,5,Western Athletic,,Rice,2003,N,N
12,7,0,5,Big East,,Rutgers,2003,N,N
12,6,0,6,Mountain West,,San Diego State,2003,N,N
11,8,0,3,Western Athletic,,San Josï¿½ State,2003,N,N
12,12,0,0,Western Athletic,,SMU,2003,N,N
12,7,0,5,SEC,East,South Carolina,2003,N,N
13,4,0,9,Conference USA,,Southern Mississippi,2003,N,N
11,4,0,7,Conference USA,,South Florida,2003,N,N
11,7,0,4,Pac-10,,Stanford,2003,N,N
12,6,0,6,Big East,,Syracuse,2003,N,N
13,2,0,11,Conference USA,,TCU,2003,N,N
12,11,0,1,Big East,,Temple,2003,N,N
13,3,0,10,SEC,East,Tennessee,2003,N,N
13,3,0,10,Big 12,South,Texas,2003,N,N
12,8,0,4,Big 12,South,Texas A&M,2003,N,N
13,5,0,8,Big 12,South,Texas Tech,2003,N,N
12,4,0,8,Mid-American,West,Toledo,2003,N,N
12,6,0,6,FBS Independents,,Troy,2003,N,N
12,7,0,5,Conference USA,,Tulane,2003,N,N
13,5,0,8,Western Athletic,,Tulsa,2003,N,N
12,7,0,5,Conference USA,,UAB,2003,N,N
12,9,0,3,Mid-American,East,UCF,2003,N,N
13,7,0,6,Pac-10,,UCLA,2003,N,N
12,6,0,6,Mountain West,,UNLV,2003,N,N
13,1,0,12,Pac-10,,USC,2003,N,N
12,2,0,10,Mountain West,,Utah,2003,N,N
12,9,0,3,Sun Belt,,Utah State,2003,N,N
13,11,0,2,Western Athletic,,UTEP,2003,N,N
12,10,0,2,SEC,East,Vanderbilt,2003,N,N
13,5,0,8,ACC,,Virginia,2003,N,N
13,5,0,8,Big East,,Virginia Tech,2003,N,N
12,7,0,5,ACC,,Wake Forest,2003,N,N
12,6,0,6,Pac-10,,Washington,2003,N,N
13,3,0,10,Pac-10,,Washington State,2003,N,N
12,7,0,5,Mid-American,West,Western Michigan,2003,N,N
13,5,0,8,Big East,,West Virginia,2003,N,N
13,6,0,7,Big Ten,,Wisconsin,2003,N,N
12,8,0,4,Mountain West,,Wyoming,2003,N,N
11,6,0,5,Mountain West,,Air Force,2004,N,N
11,5,0,6,Mid-American,East,Akron,2004,N,N
12,6,0,6,SEC,West,Alabama,2004,N,N
11,8,0,3,Pac-10,,Arizona,2004,N,N
12,3,0,9,Pac-10,,Arizona State,2004,N,N
11,6,0,5,SEC,West,Arkansas,2004,N,N
11,8,0,3,Sun Belt,East,Arkansas State,2004,N,N
11,9,0,2,Conference USA,,Army,2004,N,N
13,0,0,13,SEC,West,Auburn,2004,N,N
11,9,0,2,Mid-American,West,Ball State,2004,N,N
11,8,0,3,Big 12,South,Baylor,2004,N,N
12,1,0,11,Western Athletic,,Boise State,2004,N,N
12,3,0,9,Big East,,Boston College,2004,N,N
12,3,0,9,Mid-American,West,Bowling Green,2004,N,N
11,9,0,2,Mid-American,East,Buffalo,2004,N,N
11,6,0,5,Mountain West,,BYU,2004,N,N
12,2,0,10,Pac-10,,California,2004,N,N
11,7,0,4,Mid-American,West,Central Michigan,2004,N,N
12,5,0,7,Conference USA,,Cincinnati,2004,N,N
11,5,0,6,ACC,,Clemson,2004,N,N
13,5,0,8,Big 12,North,Colorado,2004,N,N
11,7,0,4,Mountain West,,Colorado State,2004,N,N
12,4,0,8,Big East,,Connecticut,2004,N,N
11,9,0,2,ACC,,Duke,2004,N,N
11,9,0,2,Conference USA,,East Carolina,2004,N,N
11,7,0,4,Mid-American,West,Eastern Michigan,2004,N,N
12,5,0,7,SEC,East,Florida,2004,N,N
18,12,0,6,FBS Independents,,Florida A&M,2004,N,N
12,3,0,9,ACC,,Florida State,2004,N,N
12,3,0,9,Western Athletic,,Fresno State,2004,N,N
12,2,0,10,SEC,East,Georgia,2004,N,N
12,5,0,7,ACC,,Georgia Tech,2004,N,N
13,5,0,8,Western Athletic,,Hawai'i,2004,N,N
11,8,0,3,Conference USA,,Houston,2004,N,N
12,9,0,3,Sun Belt,,Idaho,2004,N,N
11,8,0,3,Big Ten,,Illinois,2004,N,N
11,8,0,3,Big Ten,,Indiana,2004,N,N
12,2,0,10,Big Ten,,Iowa,2004,N,N
12,5,0,7,Big 12,North,Iowa State,2004,N,N
11,7,0,4,Big 12,North,Kansas,2004,N,N
11,7,0,4,Big 12,North,Kansas State,2004,N,N
11,6,0,5,Mid-American,East,Kent State,2004,N,N
11,9,0,2,SEC,East,Kentucky,2004,N,N
11,7,0,4,Sun Belt,East,Louisiana,2004,N,N
11,6,0,5,Sun Belt,East,Louisiana Monroe,2004,N,N
12,6,0,6,Western Athletic,,Louisiana Tech,2004,N,N
12,1,0,11,Conference USA,,Louisville,2004,N,N
12,3,0,9,SEC,West,LSU,2004,N,N
12,6,0,6,Mid-American,East,Marshall,2004,N,N
11,6,0,5,ACC,,Maryland,2004,N,N
12,4,0,8,Conference USA,,Memphis,2004,N,N
12,3,0,9,ACC,,Miami,2004,N,N
13,5,0,8,Mid-American,East,Miami (OH),2004,N,N
12,3,0,9,Big Ten,,Michigan,2004,N,N
12,7,0,5,Big Ten,,Michigan State,2004,N,N
11,6,0,5,Sun Belt,,Middle Tennessee,2004,N,N
12,5,0,7,Big Ten,,Minnesota,2004,N,N
11,8,0,3,SEC,West,Mississippi State,2004,N,N
11,6,0,5,Big 12,North,Missouri,2004,N,N
12,2,0,10,FBS Independents,,Navy,2004,N,N
11,6,0,5,ACC,,NC State,2004,N,N
11,6,0,5,Big 12,North,Nebraska,2004,N,N
12,7,0,5,Western Athletic,,Nevada,2004,N,N
12,5,0,7,Mountain West,,New Mexico,2004,N,N
11,6,0,5,Sun Belt,,New Mexico State,2004,N,N
12,6,0,6,ACC,,North Carolina,2004,N,N
12,3,0,9,Mid-American,West,Northern Illinois,2004,N,N
12,5,0,7,Sun Belt,,North Texas,2004,N,N
12,6,0,6,Big Ten,,Northwestern,2004,N,N
12,6,0,6,FBS Independents,,Notre Dame,2004,N,N
11,7,0,4,Mid-American,East,Ohio,2004,N,N
12,4,0,8,Big Ten,,Ohio State,2004,N,N
13,1,0,12,Big 12,South,Oklahoma,2004,N,Y
12,5,0,7,Big 12,South,Oklahoma State,2004,N,N
11,7,0,4,SEC,West,Ole Miss,2004,N,N
11,6,0,5,Pac-10,,Oregon,2004,N,N
12,5,0,7,Pac-10,,Oregon State,2004,N,N
11,7,0,4,Big Ten,,Penn State,2004,N,N
12,4,0,8,Big East,,Pittsburgh,2004,N,N
12,5,0,7,Big Ten,,Purdue,2004,N,N
11,8,0,3,Western Athletic,,Rice,2004,N,N
11,7,0,4,Big East,,Rutgers,2004,N,N
11,7,0,4,Mountain West,,San Diego State,2004,N,N
11,9,0,2,Western Athletic,,San Josï¿½ State,2004,N,N
11,8,0,3,Western Athletic,,SMU,2004,N,N
11,5,0,6,SEC,East,South Carolina,2004,N,N
12,5,0,7,Conference USA,,Southern Mississippi,2004,N,N
11,7,0,4,Conference USA,,South Florida,2004,N,N
11,7,0,4,Pac-10,,Stanford,2004,N,N
12,6,0,6,Big East,,Syracuse,2004,N,N
11,6,0,5,Conference USA,,TCU,2004,N,N
11,9,0,2,Big East,,Temple,2004,N,N
13,3,0,10,SEC,East,Tennessee,2004,N,N
12,1,0,11,Big 12,South,Texas,2004,N,N
12,5,0,7,Big 12,South,Texas A&M,2004,N,N
12,4,0,8,Big 12,South,Texas Tech,2004,N,N
13,4,0,9,Mid-American,West,Toledo,2004,N,N
12,5,0,7,Sun Belt,East,Troy,2004,N,N
11,6,0,5,Conference USA,,Tulane,2004,N,N
12,8,0,4,Western Athletic,,Tulsa,2004,N,N
12,5,0,7,Conference USA,,UAB,2004,N,N
11,11,0,0,Mid-American,East,UCF,2004,N,N
12,6,0,6,Pac-10,,UCLA,2004,N,N
11,9,0,2,Mountain West,,UNLV,2004,N,N
13,0,0,13,Pac-10,,USC,2004,Y,N
12,0,0,12,Mountain West,,Utah,2004,N,N
11,8,0,3,Sun Belt,,Utah State,2004,N,N
12,4,0,8,Western Athletic,,UTEP,2004,N,N
11,9,0,2,SEC,East,Vanderbilt,2004,N,N
12,4,0,8,ACC,,Virginia,2004,N,N
13,3,0,10,ACC,,Virginia Tech,2004,N,N
11,7,0,4,ACC,,Wake Forest,2004,N,N
11,10,0,1,Pac-10,,Washington,2004,N,N
11,6,0,5,Pac-10,,Washington State,2004,N,N
11,10,0,1,Mid-American,West,Western Michigan,2004,N,N
12,4,0,8,Big East,,West Virginia,2004,N,N
12,3,0,9,Big Ten,,Wisconsin,2004,N,N
12,5,0,7,Mountain West,,Wyoming,2004,N,N
11,7,0,4,Mountain West,,Air Force,2005,N,N
13,6,0,7,Mid-American,East,Akron,2005,N,N
12,2,0,10,SEC,West,Alabama,2005,N,N
11,8,0,3,Pac-10,,Arizona,2005,N,N
12,5,0,7,Pac-10,,Arizona State,2005,N,N
11,7,0,4,SEC,West,Arkansas,2005,N,N
12,6,0,6,Sun Belt,East,Arkansas State,2005,N,N
11,7,0,4,FBS Independents,,Army,2005,N,N
12,3,0,9,SEC,West,Auburn,2005,N,N
11,7,0,4,Mid-American,West,Ball State,2005,N,N
11,6,0,5,Big 12,South,Baylor,2005,N,N
13,4,0,9,Western Athletic,,Boise State,2005,N,N
12,3,0,9,ACC,Atlantic,Boston College,2005,N,N
11,5,0,6,Mid-American,East,Bowling Green,2005,N,N
11,10,0,1,Mid-American,East,Buffalo,2005,N,N
12,6,0,6,Mountain West,,BYU,2005,N,N
12,4,0,8,Pac-10,,California,2005,N,N
11,5,0,6,Mid-American,West,Central Michigan,2005,N,N
11,7,0,4,Big East,,Cincinnati,2005,N,N
12,4,0,8,ACC,Atlantic,Clemson,2005,N,N
13,6,0,7,Big 12,North,Colorado,2005,N,N
12,6,0,6,Mountain West,,Colorado State,2005,N,N
11,6,0,5,Big East,,Connecticut,2005,N,N
11,10,0,1,ACC,Coastal,Duke,2005,N,N
11,6,0,5,Conference USA,East,East Carolina,2005,N,N
11,7,0,4,Mid-American,West,Eastern Michigan,2005,N,N
12,3,0,9,SEC,East,Florida,2005,N,N
11,9,0,2,Sun Belt,,Florida Atlantic,2005,N,N
11,6,0,5,Sun Belt,,Florida International,2005,N,N
13,5,0,8,ACC,Atlantic,Florida State,2005,N,N
13,5,0,8,Western Athletic,,Fresno State,2005,N,N
13,3,0,10,SEC,East,Georgia,2005,N,N
12,5,0,7,ACC,Coastal,Georgia Tech,2005,N,N
12,7,0,5,Western Athletic,,Hawai'i,2005,N,N
12,6,0,6,Conference USA,West,Houston,2005,N,N
11,9,0,2,Western Athletic,,Idaho,2005,N,N
11,9,0,2,Big Ten,,Illinois,2005,N,N
11,7,0,4,Big Ten,,Indiana,2005,N,N
12,5,0,7,Big Ten,,Iowa,2005,N,N
12,5,0,7,Big 12,North,Iowa State,2005,N,N
12,5,0,7,Big 12,North,Kansas,2005,N,N
11,6,0,5,Big 12,North,Kansas State,2005,N,N
11,10,0,1,Mid-American,East,Kent State,2005,N,N
11,8,0,3,SEC,East,Kentucky,2005,N,N
11,5,0,6,Sun Belt,East,Louisiana,2005,N,N
11,6,0,5,Sun Belt,East,Louisiana Monroe,2005,N,N
11,4,0,7,Western Athletic,,Louisiana Tech,2005,N,N
12,3,0,9,Big East,,Louisville,2005,N,N
13,2,0,11,SEC,West,LSU,2005,N,N
11,7,0,4,Conference USA,East,Marshall,2005,N,N
11,6,0,5,ACC,Atlantic,Maryland,2005,N,N
12,5,0,7,Conference USA,East,Memphis,2005,N,N
12,3,0,9,ACC,Coastal,Miami,2005,N,N
11,4,0,7,Mid-American,East,Miami (OH),2005,N,N
12,5,0,7,Big Ten,,Michigan,2005,N,N
11,6,0,5,Big Ten,,Michigan State,2005,N,N
11,7,0,4,Sun Belt,,Middle Tennessee,2005,N,N
12,5,0,7,Big Ten,,Minnesota,2005,N,N
11,8,0,3,SEC,West,Mississippi State,2005,N,N
12,5,0,7,Big 12,North,Missouri,2005,N,N
12,4,0,8,FBS Independents,,Navy,2005,N,N
12,5,0,7,ACC,Atlantic,NC State,2005,N,N
12,4,0,8,Big 12,North,Nebraska,2005,N,N
12,3,0,9,Western Athletic,,Nevada,2005,N,N
11,5,0,6,Mountain West,,New Mexico,2005,N,N
12,12,0,0,Western Athletic,,New Mexico State,2005,N,N
11,6,0,5,ACC,Coastal,North Carolina,2005,N,N
12,5,0,7,Mid-American,West,Northern Illinois,2005,N,N
11,9,0,2,Sun Belt,,North Texas,2005,N,N
12,5,0,7,Big Ten,,Northwestern,2005,N,N
12,3,0,9,FBS Independents,,Notre Dame,2005,N,N
11,7,0,4,Mid-American,East,Ohio,2005,N,N
12,2,0,10,Big Ten,,Ohio State,2005,N,N
12,4,0,8,Big 12,South,Oklahoma,2005,N,N
11,7,0,4,Big 12,South,Oklahoma State,2005,N,N
11,8,0,3,SEC,West,Ole Miss,2005,N,N
12,2,0,10,Pac-10,,Oregon,2005,N,N
11,6,0,5,Pac-10,,Oregon State,2005,N,N
12,1,0,11,Big Ten,,Penn State,2005,N,N
11,6,0,5,Big East,,Pittsburgh,2005,N,N
11,6,0,5,Big Ten,,Purdue,2005,N,N
11,10,0,1,Conference USA,West,Rice,2005,N,N
12,5,0,7,Big East,,Rutgers,2005,N,N
12,7,0,5,Mountain West,,San Diego State,2005,N,N
11,8,0,3,Western Athletic,,San Josï¿½ State,2005,N,N
11,6,0,5,Conference USA,West,SMU,2005,N,N
12,5,0,7,SEC,East,South Carolina,2005,N,N
12,5,0,7,Conference USA,East,Southern Mississippi,2005,N,N
12,6,0,6,Big East,,South Florida,2005,N,N
11,6,0,5,Pac-10,,Stanford,2005,N,N
11,10,0,1,Big East,,Syracuse,2005,N,N
12,1,0,11,Mountain West,,TCU,2005,N,N
11,11,0,0,FBS Independents,,Temple,2005,N,N
11,6,0,5,SEC,East,Tennessee,2005,N,N
13,0,0,13,Big 12,South,Texas,2005,Y,N
11,6,0,5,Big 12,South,Texas A&M,2005,N,N
12,3,0,9,Big 12,South,Texas Tech,2005,N,N
12,3,0,9,Mid-American,West,Toledo,2005,N,N
11,7,0,4,Sun Belt,East,Troy,2005,N,N
11,9,0,2,Conference USA,West,Tulane,2005,N,N
13,4,0,9,Conference USA,West,Tulsa,2005,N,N
11,6,0,5,Conference USA,East,UAB,2005,N,N
13,5,0,8,Conference USA,East,UCF,2005,N,N
12,2,0,10,Pac-10,,UCLA,2005,N,N
11,9,0,2,Mountain West,,UNLV,2005,N,N
13,1,0,12,Pac-10,,USC,2005,N,Y
12,5,0,7,Mountain West,,Utah,2005,N,N
11,8,0,3,Western Athletic,,Utah State,2005,N,N
12,4,0,8,Conference USA,West,UTEP,2005,N,N
11,6,0,5,SEC,East,Vanderbilt,2005,N,N
12,5,0,7,ACC,Coastal,Virginia,2005,N,N
13,2,0,11,ACC,Coastal,Virginia Tech,2005,N,N
11,7,0,4,ACC,Atlantic,Wake Forest,2005,N,N
11,9,0,2,Pac-10,,Washington,2005,N,N
11,7,0,4,Pac-10,,Washington State,2005,N,N
11,4,0,7,Mid-American,West,Western Michigan,2005,N,N
12,1,0,11,Big East,,West Virginia,2005,N,N
13,3,0,10,Big Ten,,Wisconsin,2005,N,N
11,7,0,4,Mountain West,,Wyoming,2005,N,N
12,8,0,4,Mountain West,,Air Force,2006,N,N
12,7,0,5,Mid-American,East,Akron,2006,N,N
13,7,0,6,SEC,West,Alabama,2006,N,N
12,6,0,6,Pac-10,,Arizona,2006,N,N
13,6,0,7,Pac-10,,Arizona State,2006,N,N
14,4,0,10,SEC,West,Arkansas,2006,N,N
12,6,0,6,Sun Belt,East,Arkansas State,2006,N,N
12,9,0,3,FBS Independents,,Army,2006,N,N
13,2,0,11,SEC,West,Auburn,2006,N,N
12,7,0,5,Mid-American,West,Ball State,2006,N,N
12,8,0,4,Big 12,South,Baylor,2006,N,N
13,0,0,13,Western Athletic,,Boise State,2006,N,N
13,3,0,10,ACC,Atlantic,Boston College,2006,N,N
12,8,0,4,Mid-American,East,Bowling Green,2006,N,N
12,10,0,2,Mid-American,East,Buffalo,2006,N,N
13,2,0,11,Mountain West,,BYU,2006,N,N
13,3,0,10,Pac-10,,California,2006,N,N
14,4,0,10,Mid-American,West,Central Michigan,2006,N,N
13,5,0,8,Big East,,Cincinnati,2006,N,N
13,5,0,8,ACC,Atlantic,Clemson,2006,N,N
12,10,0,2,Big 12,North,Colorado,2006,N,N
12,8,0,4,Mountain West,,Colorado State,2006,N,N
12,8,0,4,Big East,,Connecticut,2006,N,N
12,12,0,0,ACC,Coastal,Duke,2006,N,N
13,6,0,7,Conference USA,East,East Carolina,2006,N,N
12,11,0,1,Mid-American,West,Eastern Michigan,2006,N,N
14,1,0,13,SEC,East,Florida,2006,Y,N
12,7,0,5,Sun Belt,,Florida Atlantic,2006,N,N
12,12,0,0,Sun Belt,,Florida International,2006,N,N
13,6,0,7,ACC,Atlantic,Florida State,2006,N,N
12,8,0,4,Western Athletic,,Fresno State,2006,N,N
13,4,0,9,SEC,East,Georgia,2006,N,N
14,5,0,9,ACC,Coastal,Georgia Tech,2006,N,N
14,3,0,11,Western Athletic,,Hawai'i,2006,N,N
14,4,0,10,Conference USA,West,Houston,2006,N,N
12,8,0,4,Western Athletic,,Idaho,2006,N,N
12,10,0,2,Big Ten,,Illinois,2006,N,N
12,7,0,5,Big Ten,,Indiana,2006,N,N
13,7,0,6,Big Ten,,Iowa,2006,N,N
12,8,0,4,Big 12,North,Iowa State,2006,N,N
12,6,0,6,Big 12,North,Kansas,2006,N,N
13,6,0,7,Big 12,North,Kansas State,2006,N,N
12,6,0,6,Mid-American,East,Kent State,2006,N,N
13,5,0,8,SEC,East,Kentucky,2006,N,N
12,6,0,6,Sun Belt,East,Louisiana,2006,N,N
12,8,0,4,Sun Belt,East,Louisiana Monroe,2006,N,N
13,10,0,3,Western Athletic,,Louisiana Tech,2006,N,N
13,1,0,12,Big East,,Louisville,2006,N,N
13,2,0,11,SEC,West,LSU,2006,N,N
12,7,0,5,Conference USA,East,Marshall,2006,N,N
13,4,0,9,ACC,Atlantic,Maryland,2006,N,N
12,10,0,2,Conference USA,East,Memphis,2006,N,N
13,6,0,7,ACC,Coastal,Miami,2006,N,N
12,10,0,2,Mid-American,East,Miami (OH),2006,N,N
13,2,0,11,Big Ten,,Michigan,2006,N,N
12,8,0,4,Big Ten,,Michigan State,2006,N,N
13,6,0,7,Sun Belt,,Middle Tennessee,2006,N,N
13,7,0,6,Big Ten,,Minnesota,2006,N,N
12,9,0,3,SEC,West,Mississippi State,2006,N,N
13,5,0,8,Big 12,North,Missouri,2006,N,N
13,4,0,9,FBS Independents,,Navy,2006,N,N
12,9,0,3,ACC,Atlantic,NC State,2006,N,N
14,5,0,9,Big 12,North,Nebraska,2006,N,N
13,5,0,8,Western Athletic,,Nevada,2006,N,N
13,7,0,6,Mountain West,,New Mexico,2006,N,N
12,8,0,4,Western Athletic,,New Mexico State,2006,N,N
12,9,0,3,ACC,Coastal,North Carolina,2006,N,N
13,6,0,7,Mid-American,West,Northern Illinois,2006,N,N
12,9,0,3,Sun Belt,,North Texas,2006,N,N
12,8,0,4,Big Ten,,Northwestern,2006,N,N
13,3,0,10,FBS Independents,,Notre Dame,2006,N,N
14,5,0,9,Mid-American,East,Ohio,2006,N,N
13,1,0,12,Big Ten,,Ohio State,2006,N,Y
14,3,0,11,Big 12,South,Oklahoma,2006,N,N
13,6,0,7,Big 12,South,Oklahoma State,2006,N,N
12,8,0,4,SEC,West,Ole Miss,2006,N,N
13,6,0,7,Pac-10,,Oregon,2006,N,N
14,4,0,10,Pac-10,,Oregon State,2006,N,N
13,4,0,9,Big Ten,,Penn State,2006,N,N
12,6,0,6,Big East,,Pittsburgh,2006,N,N
14,6,0,8,Big Ten,,Purdue,2006,N,N
13,6,0,7,Conference USA,West,Rice,2006,N,N
13,2,0,11,Big East,,Rutgers,2006,N,N
12,9,0,3,Mountain West,,San Diego State,2006,N,N
13,4,0,9,Western Athletic,,San Josï¿½ State,2006,N,N
12,6,0,6,Conference USA,West,SMU,2006,N,N
13,5,0,8,SEC,East,South Carolina,2006,N,N
14,5,0,9,Conference USA,East,Southern Mississippi,2006,N,N
13,4,0,9,Big East,,South Florida,2006,N,N
12,11,0,1,Pac-10,,Stanford,2006,N,N
12,8,0,4,Big East,,Syracuse,2006,N,N
13,2,0,11,Mountain West,,TCU,2006,N,N
12,11,0,1,FBS Independents,,Temple,2006,N,N
13,4,0,9,SEC,East,Tennessee,2006,N,N
13,3,0,10,Big 12,South,Texas,2006,N,N
13,4,0,9,Big 12,South,Texas A&M,2006,N,N
13,5,0,8,Big 12,South,Texas Tech,2006,N,N
12,7,0,5,Mid-American,West,Toledo,2006,N,N
13,5,0,8,Sun Belt,East,Troy,2006,N,N
12,8,0,4,Conference USA,West,Tulane,2006,N,N
13,5,0,8,Conference USA,West,Tulsa,2006,N,N
12,9,0,3,Conference USA,East,UAB,2006,N,N
12,8,0,4,Conference USA,East,UCF,2006,N,N
13,6,0,7,Pac-10,,UCLA,2006,N,N
12,10,0,2,Mountain West,,UNLV,2006,N,N
13,2,0,11,Pac-10,,USC,2006,N,N
13,5,0,8,Mountain West,,Utah,2006,N,N
12,11,0,1,Western Athletic,,Utah State,2006,N,N
12,7,0,5,Conference USA,West,UTEP,2006,N,N
12,8,0,4,SEC,East,Vanderbilt,2006,N,N
12,7,0,5,ACC,Coastal,Virginia,2006,N,N
13,3,0,10,ACC,Coastal,Virginia Tech,2006,N,N
14,3,0,11,ACC,Atlantic,Wake Forest,2006,N,N
12,7,0,5,Pac-10,,Washington,2006,N,N
12,6,0,6,Pac-10,,Washington State,2006,N,N
13,5,0,8,Mid-American,West,Western Michigan,2006,N,N
13,2,0,11,Big East,,West Virginia,2006,N,N
13,1,0,12,Big Ten,,Wisconsin,2006,N,N
12,6,0,6,Mountain West,,Wyoming,2006,N,N
13,4,0,9,Mountain West,,Air Force,2007,N,N
12,8,0,4,Mid-American,East,Akron,2007,N,N
13,6,0,7,SEC,West,Alabama,2007,N,N
12,7,0,5,Pac-10,,Arizona,2007,N,N
13,3,0,10,Pac-10,,Arizona State,2007,N,N
13,5,0,8,SEC,West,Arkansas,2007,N,N
12,7,0,5,Sun Belt,East,Arkansas State,2007,N,N
12,9,0,3,FBS Independents,,Army,2007,N,N
13,4,0,9,SEC,West,Auburn,2007,N,N
13,6,0,7,Mid-American,West,Ball State,2007,N,N
12,9,0,3,Big 12,South,Baylor,2007,N,N
13,3,0,10,Western Athletic,,Boise State,2007,N,N
14,3,0,11,ACC,Atlantic,Boston College,2007,N,N
13,5,0,8,Mid-American,East,Bowling Green,2007,N,N
12,7,0,5,Mid-American,East,Buffalo,2007,N,N
13,2,0,11,Mountain West,,BYU,2007,N,N
13,6,0,7,Pac-10,,California,2007,N,N
14,6,0,8,Mid-American,West,Central Michigan,2007,N,N
13,3,0,10,Big East,,Cincinnati,2007,N,N
13,4,0,9,ACC,Atlantic,Clemson,2007,N,N
13,7,0,6,Big 12,North,Colorado,2007,N,N
12,9,0,3,Mountain West,,Colorado State,2007,N,N
13,4,0,9,Big East,,Connecticut,2007,N,N
12,11,0,1,ACC,Coastal,Duke,2007,N,N
13,5,0,8,Conference USA,East,East Carolina,2007,N,N
12,8,0,4,Mid-American,West,Eastern Michigan,2007,N,N
13,4,0,9,SEC,East,Florida,2007,N,N
13,5,0,8,Sun Belt,,Florida Atlantic,2007,N,N
12,11,0,1,Sun Belt,,Florida International,2007,N,N
13,6,0,7,ACC,Atlantic,Florida State,2007,N,N
13,4,0,9,Western Athletic,,Fresno State,2007,N,N
13,2,0,11,SEC,East,Georgia,2007,N,N
13,6,0,7,ACC,Coastal,Georgia Tech,2007,N,N
13,1,0,12,Western Athletic,,Hawai'i,2007,N,N
13,5,0,8,Conference USA,West,Houston,2007,N,N
12,11,0,1,Western Athletic,,Idaho,2007,N,N
13,4,0,9,Big Ten,,Illinois,2007,N,N
13,6,0,7,Big Ten,,Indiana,2007,N,N
12,6,0,6,Big Ten,,Iowa,2007,N,N
12,9,0,3,Big 12,North,Iowa State,2007,N,N
13,1,0,12,Big 12,North,Kansas,2007,N,N
12,7,0,5,Big 12,North,Kansas State,2007,N,N
12,9,0,3,Mid-American,East,Kent State,2007,N,N
13,5,0,8,SEC,East,Kentucky,2007,N,N
12,9,0,3,Sun Belt,East,Louisiana,2007,N,N
12,6,0,6,Sun Belt,East,Louisiana Monroe,2007,N,N
12,7,0,5,Western Athletic,,Louisiana Tech,2007,N,N
12,6,0,6,Big East,,Louisville,2007,N,N
14,2,0,12,SEC,West,LSU,2007,Y,N
12,9,0,3,Conference USA,East,Marshall,2007,N,N
13,7,0,6,ACC,Atlantic,Maryland,2007,N,N
13,6,0,7,Conference USA,East,Memphis,2007,N,N
12,7,0,5,ACC,Coastal,Miami,2007,N,N
13,7,0,6,Mid-American,East,Miami (OH),2007,N,N
13,4,0,9,Big Ten,,Michigan,2007,N,N
13,6,0,7,Big Ten,,Michigan State,2007,N,N
12,7,0,5,Sun Belt,,Middle Tennessee,2007,N,N
12,11,0,1,Big Ten,,Minnesota,2007,N,N
13,5,0,8,SEC,West,Mississippi State,2007,N,N
14,2,0,12,Big 12,North,Missouri,2007,N,N
13,5,0,8,FBS Independents,,Navy,2007,N,N
12,7,0,5,ACC,Atlantic,NC State,2007,N,N
12,7,0,5,Big 12,North,Nebraska,2007,N,N
13,7,0,6,Western Athletic,,Nevada,2007,N,N
13,4,0,9,Mountain West,,New Mexico,2007,N,N
13,9,0,4,Western Athletic,,New Mexico State,2007,N,N
12,8,0,4,ACC,Coastal,North Carolina,2007,N,N
12,10,0,2,Mid-American,West,Northern Illinois,2007,N,N
12,10,0,2,Sun Belt,,North Texas,2007,N,N
12,6,0,6,Big Ten,,Northwestern,2007,N,N
12,9,0,3,FBS Independents,,Notre Dame,2007,N,N
12,6,0,6,Mid-American,East,Ohio,2007,N,N
13,2,0,11,Big Ten,,Ohio State,2007,N,Y
14,3,0,11,Big 12,South,Oklahoma,2007,N,N
13,6,0,7,Big 12,South,Oklahoma State,2007,N,N
12,9,0,3,SEC,West,Ole Miss,2007,N,N
13,4,0,9,Pac-10,,Oregon,2007,N,N
13,4,0,9,Pac-10,,Oregon State,2007,N,N
13,4,0,9,Big Ten,,Penn State,2007,N,N
12,7,0,5,Big East,,Pittsburgh,2007,N,N
13,5,0,8,Big Ten,,Purdue,2007,N,N
12,9,0,3,Conference USA,West,Rice,2007,N,N
13,5,0,8,Big East,,Rutgers,2007,N,N
12,8,0,4,Mountain West,,San Diego State,2007,N,N
12,7,0,5,Western Athletic,,San Josï¿½ State,2007,N,N
12,11,0,1,Conference USA,West,SMU,2007,N,N
12,6,0,6,SEC,East,South Carolina,2007,N,N
13,6,0,7,Conference USA,East,Southern Mississippi,2007,N,N
13,4,0,9,Big East,,South Florida,2007,N,N
12,8,0,4,Pac-10,,Stanford,2007,N,N
12,10,0,2,Big East,,Syracuse,2007,N,N
13,5,0,8,Mountain West,,TCU,2007,N,N
12,8,0,4,Mid-American,East,Temple,2007,N,N
14,4,0,10,SEC,East,Tennessee,2007,N,N
13,3,0,10,Big 12,South,Texas,2007,N,N
13,6,0,7,Big 12,South,Texas A&M,2007,N,N
13,4,0,9,Big 12,South,Texas Tech,2007,N,N
12,7,0,5,Mid-American,West,Toledo,2007,N,N
12,4,0,8,Sun Belt,East,Troy,2007,N,N
12,8,0,4,Conference USA,West,Tulane,2007,N,N
14,4,0,10,Conference USA,West,Tulsa,2007,N,N
12,10,0,2,Conference USA,East,UAB,2007,N,N
14,4,0,10,Conference USA,East,UCF,2007,N,N
13,7,0,6,Pac-10,,UCLA,2007,N,N
12,10,0,2,Mountain West,,UNLV,2007,N,N
13,2,0,11,Pac-10,,USC,2007,N,N
13,4,0,9,Mountain West,,Utah,2007,N,N
12,10,0,2,Western Athletic,,Utah State,2007,N,N
12,8,0,4,Conference USA,West,UTEP,2007,N,N
12,7,0,5,SEC,East,Vanderbilt,2007,N,N
13,4,0,9,ACC,Coastal,Virginia,2007,N,N
14,3,0,11,ACC,Coastal,Virginia Tech,2007,N,N
13,4,0,9,ACC,Atlantic,Wake Forest,2007,N,N
13,9,0,4,Pac-10,,Washington,2007,N,N
12,7,0,5,Pac-10,,Washington State,2007,N,N
12,5,0,7,FBS Independents,,Western Kentucky,2007,N,N
12,7,0,5,Mid-American,West,Western Michigan,2007,N,N
13,2,0,11,Big East,,West Virginia,2007,N,N
13,4,0,9,Big Ten,,Wisconsin,2007,N,N
12,7,0,5,Mountain West,,Wyoming,2007,N,N
13,5,0,8,Mountain West,,Air Force,2008,N,N
12,7,0,5,Mid-American,East,Akron,2008,N,N
14,2,0,12,SEC,West,Alabama,2008,N,N
13,5,0,8,Pac-10,,Arizona,2008,N,N
12,7,0,5,Pac-10,,Arizona State,2008,N,N
12,7,0,5,SEC,West,Arkansas,2008,N,N
12,6,0,6,Sun Belt,East,Arkansas State,2008,N,N
12,9,0,3,FBS Independents,,Army,2008,N,N
12,7,0,5,SEC,West,Auburn,2008,N,N
14,2,0,12,Mid-American,West,Ball State,2008,N,N
12,8,0,4,Big 12,South,Baylor,2008,N,N
13,1,0,12,Western Athletic,,Boise State,2008,N,N
14,5,0,9,ACC,Atlantic,Boston College,2008,N,N
12,6,0,6,Mid-American,East,Bowling Green,2008,N,N
14,6,0,8,Mid-American,East,Buffalo,2008,N,N
13,3,0,10,Mountain West,,BYU,2008,N,N
13,4,0,9,Pac-10,,California,2008,N,N
13,5,0,8,Mid-American,West,Central Michigan,2008,N,N
14,3,0,11,Big East,,Cincinnati,2008,N,N
13,6,0,7,ACC,Atlantic,Clemson,2008,N,N
12,7,0,5,Big 12,North,Colorado,2008,N,N
13,6,0,7,Mountain West,,Colorado State,2008,N,N
13,5,0,8,Big East,,Connecticut,2008,N,N
12,8,0,4,ACC,Coastal,Duke,2008,N,N
14,5,0,9,Conference USA,East,East Carolina,2008,N,N
12,9,0,3,Mid-American,West,Eastern Michigan,2008,N,N
14,1,0,13,SEC,East,Florida,2008,Y,N
13,6,0,7,Sun Belt,,Florida Atlantic,2008,N,N
12,7,0,5,Sun Belt,,Florida International,2008,N,N
13,4,0,9,ACC,Atlantic,Florida State,2008,N,N
13,6,0,7,Western Athletic,,Fresno State,2008,N,N
13,3,0,10,SEC,East,Georgia,2008,N,N
13,4,0,9,ACC,Coastal,Georgia Tech,2008,N,N
14,7,0,7,Western Athletic,,Hawai'i,2008,N,N
13,5,0,8,Conference USA,West,Houston,2008,N,N
12,10,0,2,Western Athletic,,Idaho,2008,N,N
12,7,0,5,Big Ten,,Illinois,2008,N,N
12,9,0,3,Big Ten,,Indiana,2008,N,N
13,4,0,9,Big Ten,,Iowa,2008,N,N
12,10,0,2,Big 12,North,Iowa State,2008,N,N
13,5,0,8,Big 12,North,Kansas,2008,N,N
12,7,0,5,Big 12,North,Kansas State,2008,N,N
12,8,0,4,Mid-American,East,Kent State,2008,N,N
13,6,0,7,SEC,East,Kentucky,2008,N,N
12,6,0,6,Sun Belt,East,Louisiana,2008,N,N
12,8,0,4,Sun Belt,East,Louisiana Monroe,2008,N,N
13,5,0,8,Western Athletic,,Louisiana Tech,2008,N,N
12,7,0,5,Big East,,Louisville,2008,N,N
14,5,0,9,SEC,West,LSU,2008,N,N
12,8,0,4,Conference USA,East,Marshall,2008,N,N
13,5,0,8,ACC,Atlantic,Maryland,2008,N,N
13,7,0,6,Conference USA,East,Memphis,2008,N,N
13,6,0,7,ACC,Coastal,Miami,2008,N,N
12,10,0,2,Mid-American,East,Miami (OH),2008,N,N
12,9,0,3,Big Ten,,Michigan,2008,N,N
13,4,0,9,Big Ten,,Michigan State,2008,N,N
12,7,0,5,Sun Belt,,Middle Tennessee,2008,N,N
13,6,0,7,Big Ten,,Minnesota,2008,N,N
12,8,0,4,SEC,West,Mississippi State,2008,N,N
14,4,0,10,Big 12,North,Missouri,2008,N,N
13,5,0,8,FBS Independents,,Navy,2008,N,N
13,7,0,6,ACC,Atlantic,NC State,2008,N,N
13,4,0,9,Big 12,North,Nebraska,2008,N,N
13,6,0,7,Western Athletic,,Nevada,2008,N,N
12,8,0,4,Mountain West,,New Mexico,2008,N,N
12,9,0,3,Western Athletic,,New Mexico State,2008,N,N
13,5,0,8,ACC,Coastal,North Carolina,2008,N,N
13,7,0,6,Mid-American,West,Northern Illinois,2008,N,N
12,11,0,1,Sun Belt,,North Texas,2008,N,N
13,4,0,9,Big Ten,,Northwestern,2008,N,N
13,6,0,7,FBS Independents,,Notre Dame,2008,N,N
12,8,0,4,Mid-American,East,Ohio,2008,N,N
13,3,0,10,Big Ten,,Ohio State,2008,N,N
14,2,0,12,Big 12,South,Oklahoma,2008,N,Y
13,4,0,9,Big 12,South,Oklahoma State,2008,N,N
13,4,0,9,SEC,West,Ole Miss,2008,N,N
13,3,0,10,Pac-10,,Oregon,2008,N,N
13,4,0,9,Pac-10,,Oregon State,2008,N,N
13,2,0,11,Big Ten,,Penn State,2008,N,N
13,4,0,9,Big East,,Pittsburgh,2008,N,N
12,8,0,4,Big Ten,,Purdue,2008,N,N
13,3,0,10,Conference USA,West,Rice,2008,N,N
13,5,0,8,Big East,,Rutgers,2008,N,N
12,10,0,2,Mountain West,,San Diego State,2008,N,N
12,6,0,6,Western Athletic,,San Josï¿½ State,2008,N,N
12,11,0,1,Conference USA,West,SMU,2008,N,N
13,6,0,7,SEC,East,South Carolina,2008,N,N
13,6,0,7,Conference USA,East,Southern Mississippi,2008,N,N
13,5,0,8,Big East,,South Florida,2008,N,N
12,7,0,5,Pac-10,,Stanford,2008,N,N
12,9,0,3,Big East,,Syracuse,2008,N,N
13,2,0,11,Mountain West,,TCU,2008,N,N
12,7,0,5,Mid-American,East,Temple,2008,N,N
12,7,0,5,SEC,East,Tennessee,2008,N,N
13,1,0,12,Big 12,South,Texas,2008,N,N
12,8,0,4,Big 12,South,Texas A&M,2008,N,N
13,2,0,11,Big 12,South,Texas Tech,2008,N,N
12,9,0,3,Mid-American,West,Toledo,2008,N,N
13,5,0,8,Sun Belt,East,Troy,2008,N,N
12,10,0,2,Conference USA,West,Tulane,2008,N,N
14,3,0,11,Conference USA,West,Tulsa,2008,N,N
12,8,0,4,Conference USA,East,UAB,2008,N,N
12,8,0,4,Conference USA,East,UCF,2008,N,N
12,8,0,4,Pac-10,,UCLA,2008,N,N
12,7,0,5,Mountain West,,UNLV,2008,N,N
13,1,0,12,Pac-10,,USC,2008,N,N
13,0,0,13,Mountain West,,Utah,2008,N,N
12,9,0,3,Western Athletic,,Utah State,2008,N,N
12,7,0,5,Conference USA,West,UTEP,2008,N,N
13,6,0,7,SEC,East,Vanderbilt,2008,N,N
12,7,0,5,ACC,Coastal,Virginia,2008,N,N
14,4,0,10,ACC,Coastal,Virginia Tech,2008,N,N
13,5,0,8,ACC,Atlantic,Wake Forest,2008,N,N
12,12,0,0,Pac-10,,Washington,2008,N,N
13,11,0,2,Pac-10,,Washington State,2008,N,N
12,10,0,2,FBS Independents,,Western Kentucky,2008,N,N
13,4,0,9,Mid-American,West,Western Michigan,2008,N,N
13,4,0,9,Big East,,West Virginia,2008,N,N
13,6,0,7,Big Ten,,Wisconsin,2008,N,N
12,8,0,4,Mountain West,,Wyoming,2008,N,N
13,5,0,8,Mountain West,,Air Force,2009,N,N
12,9,0,3,Mid-American,East,Akron,2009,N,N
14,0,0,14,SEC,West,Alabama,2009,Y,N
13,5,0,8,Pac-10,,Arizona,2009,N,N
12,8,0,4,Pac-10,,Arizona State,2009,N,N
13,5,0,8,SEC,West,Arkansas,2009,N,N
12,8,0,4,Sun Belt,East,Arkansas State,2009,N,N
12,7,0,5,FBS Independents,,Army,2009,N,N
13,5,0,8,SEC,West,Auburn,2009,N,N
12,10,0,2,Mid-American,West,Ball State,2009,N,N
12,8,0,4,Big 12,South,Baylor,2009,N,N
14,0,0,14,Western Athletic,,Boise State,2009,N,N
13,5,0,8,ACC,Atlantic,Boston College,2009,N,N
13,6,0,7,Mid-American,East,Bowling Green,2009,N,N
12,7,0,5,Mid-American,East,Buffalo,2009,N,N
13,2,0,11,Mountain West,,BYU,2009,N,N
13,5,0,8,Pac-10,,California,2009,N,N
14,2,0,12,Mid-American,West,Central Michigan,2009,N,N
13,1,0,12,Big East,,Cincinnati,2009,N,N
14,5,0,9,ACC,Atlantic,Clemson,2009,N,N
12,9,0,3,Big 12,North,Colorado,2009,N,N
12,9,0,3,Mountain West,,Colorado State,2009,N,N
13,5,0,8,Big East,,Connecticut,2009,N,N
12,7,0,5,ACC,Coastal,Duke,2009,N,N
14,5,0,9,Conference USA,East,East Carolina,2009,N,N
12,12,0,0,Mid-American,West,Eastern Michigan,2009,N,N
14,1,0,13,SEC,East,Florida,2009,N,N
12,7,0,5,Sun Belt,,Florida Atlantic,2009,N,N
12,9,0,3,Sun Belt,,Florida International,2009,N,N
13,6,0,7,ACC,Atlantic,Florida State,2009,N,N
13,5,0,8,Western Athletic,,Fresno State,2009,N,N
13,5,0,8,SEC,East,Georgia,2009,N,N
14,3,0,11,ACC,Coastal,Georgia Tech,2009,N,N
13,7,0,6,Western Athletic,,Hawai'i,2009,N,N
14,4,0,10,Conference USA,West,Houston,2009,N,N
13,5,0,8,Western Athletic,,Idaho,2009,N,N
12,9,0,3,Big Ten,,Illinois,2009,N,N
12,8,0,4,Big Ten,,Indiana,2009,N,N
13,2,0,11,Big Ten,,Iowa,2009,N,N
13,6,0,7,Big 12,North,Iowa State,2009,N,N
12,7,0,5,Big 12,North,Kansas,2009,N,N
12,6,0,6,Big 12,North,Kansas State,2009,N,N
12,7,0,5,Mid-American,East,Kent State,2009,N,N
13,6,0,7,SEC,East,Kentucky,2009,N,N
12,6,0,6,Sun Belt,East,Louisiana,2009,N,N
12,6,0,6,Sun Belt,East,Louisiana Monroe,2009,N,N
12,8,0,4,Western Athletic,,Louisiana Tech,2009,N,N
12,8,0,4,Big East,,Louisville,2009,N,N
13,4,0,9,SEC,West,LSU,2009,N,N
13,6,0,7,Conference USA,East,Marshall,2009,N,N
12,10,0,2,ACC,Atlantic,Maryland,2009,N,N
12,10,0,2,Conference USA,East,Memphis,2009,N,N
13,4,0,9,ACC,Coastal,Miami,2009,N,N
12,11,0,1,Mid-American,East,Miami (OH),2009,N,N
12,7,0,5,Big Ten,,Michigan,2009,N,N
13,7,0,6,Big Ten,,Michigan State,2009,N,N
13,3,0,10,Sun Belt,,Middle Tennessee,2009,N,N
13,7,0,6,Big Ten,,Minnesota,2009,N,N
12,7,0,5,SEC,West,Mississippi State,2009,N,N
13,5,0,8,Big 12,North,Missouri,2009,N,N
14,4,0,10,FBS Independents,,Navy,2009,N,N
12,7,0,5,ACC,Atlantic,NC State,2009,N,N
14,4,0,10,Big 12,North,Nebraska,2009,N,N
13,5,0,8,Western Athletic,,Nevada,2009,N,N
12,11,0,1,Mountain West,,New Mexico,2009,N,N
13,10,0,3,Western Athletic,,New Mexico State,2009,N,N
13,5,0,8,ACC,Coastal,North Carolina,2009,N,N
13,6,0,7,Mid-American,West,Northern Illinois,2009,N,N
12,10,0,2,Sun Belt,,North Texas,2009,N,N
13,5,0,8,Big Ten,,Northwestern,2009,N,N
12,6,0,6,FBS Independents,,Notre Dame,2009,N,N
14,5,0,9,Mid-American,East,Ohio,2009,N,N
13,2,0,11,Big Ten,,Ohio State,2009,N,N
13,5,0,8,Big 12,South,Oklahoma,2009,N,N
13,4,0,9,Big 12,South,Oklahoma State,2009,N,N
13,4,0,9,SEC,West,Ole Miss,2009,N,N
13,3,0,10,Pac-10,,Oregon,2009,N,N
13,5,0,8,Pac-10,,Oregon State,2009,N,N
13,2,0,11,Big Ten,,Penn State,2009,N,N
13,3,0,10,Big East,,Pittsburgh,2009,N,N
12,7,0,5,Big Ten,,Purdue,2009,N,N
12,10,0,2,Conference USA,West,Rice,2009,N,N
13,4,0,9,Big East,,Rutgers,2009,N,N
12,8,0,4,Mountain West,,San Diego State,2009,N,N
12,10,0,2,Western Athletic,,San Josï¿½ State,2009,N,N
13,5,0,8,Conference USA,West,SMU,2009,N,N
13,6,0,7,SEC,East,South Carolina,2009,N,N
13,6,0,7,Conference USA,East,Southern Mississippi,2009,N,N
13,5,0,8,Big East,,South Florida,2009,N,N
13,5,0,8,Pac-10,,Stanford,2009,N,N
12,8,0,4,Big East,,Syracuse,2009,N,N
13,1,0,12,Mountain West,,TCU,2009,N,N
13,4,0,9,Mid-American,East,Temple,2009,N,N
13,6,0,7,SEC,East,Tennessee,2009,N,N
14,1,0,13,Big 12,South,Texas,2009,N,Y
13,7,0,6,Big 12,South,Texas A&M,2009,N,N
13,4,0,9,Big 12,South,Texas Tech,2009,N,N
12,7,0,5,Mid-American,West,Toledo,2009,N,N
13,4,0,9,Sun Belt,East,Troy,2009,N,N
12,9,0,3,Conference USA,West,Tulane,2009,N,N
12,7,0,5,Conference USA,West,Tulsa,2009,N,N
12,7,0,5,Conference USA,East,UAB,2009,N,N
13,5,0,8,Conference USA,East,UCF,2009,N,N
13,6,0,7,Pac-10,,UCLA,2009,N,N
12,7,0,5,Mountain West,,UNLV,2009,N,N
13,4,0,9,Pac-10,,USC,2009,N,N
13,3,0,10,Mountain West,,Utah,2009,N,N
12,8,0,4,Western Athletic,,Utah State,2009,N,N
12,8,0,4,Conference USA,West,UTEP,2009,N,N
12,10,0,2,SEC,East,Vanderbilt,2009,N,N
12,9,0,3,ACC,Coastal,Virginia,2009,N,N
13,3,0,10,ACC,Coastal,Virginia Tech,2009,N,N
12,7,0,5,ACC,Atlantic,Wake Forest,2009,N,N
12,7,0,5,Pac-10,,Washington,2009,N,N
12,11,0,1,Pac-10,,Washington State,2009,N,N
12,12,0,0,Sun Belt,,Western Kentucky,2009,N,N
12,7,0,5,Mid-American,West,Western Michigan,2009,N,N
13,4,0,9,Big East,,West Virginia,2009,N,N
13,3,0,10,Big Ten,,Wisconsin,2009,N,N
13,6,0,7,Mountain West,,Wyoming,2009,N,N
13,4,0,9,Mountain West,,Air Force,2010,N,N
12,11,0,1,Mid-American,East,Akron,2010,N,N
13,3,0,10,SEC,West,Alabama,2010,N,N
13,6,0,7,Pac-10,,Arizona,2010,N,N
12,6,0,6,Pac-10,,Arizona State,2010,N,N
13,3,0,10,SEC,West,Arkansas,2010,N,N
12,8,0,4,Sun Belt,East,Arkansas State,2010,N,N
13,6,0,7,FBS Independents,,Army,2010,N,N
14,0,0,14,SEC,West,Auburn,2010,Y,N
12,8,0,4,Mid-American,West,Ball State,2010,N,N
13,6,0,7,Big 12,South,Baylor,2010,N,N
13,1,0,12,Western Athletic,,Boise State,2010,N,N
13,6,0,7,ACC,Atlantic,Boston College,2010,N,N
12,10,0,2,Mid-American,East,Bowling Green,2010,N,N
12,10,0,2,Mid-American,East,Buffalo,2010,N,N
13,6,0,7,Mountain West,,BYU,2010,N,N
12,7,0,5,Pac-10,,California,2010,N,N
12,9,0,3,Mid-American,West,Central Michigan,2010,N,N
12,8,0,4,Big East,,Cincinnati,2010,N,N
13,7,0,6,ACC,Atlantic,Clemson,2010,N,N
12,7,0,5,Big 12,North,Colorado,2010,N,N
12,9,0,3,Mountain West,,Colorado State,2010,N,N
13,5,0,8,Big East,,Connecticut,2010,N,N
12,9,0,3,ACC,Coastal,Duke,2010,N,N
13,7,0,6,Conference USA,East,East Carolina,2010,N,N
12,10,0,2,Mid-American,West,Eastern Michigan,2010,N,N
13,5,0,8,SEC,East,Florida,2010,N,N
12,8,0,4,Sun Belt,,Florida Atlantic,2010,N,N
13,6,0,7,Sun Belt,,Florida International,2010,N,N
14,4,0,10,ACC,Atlantic,Florida State,2010,N,N
13,5,0,8,Western Athletic,,Fresno State,2010,N,N
13,7,0,6,SEC,East,Georgia,2010,N,N
13,7,0,6,ACC,Coastal,Georgia Tech,2010,N,N
14,4,0,10,Western Athletic,,Hawai'i,2010,N,N
12,7,0,5,Conference USA,West,Houston,2010,N,N
13,7,0,6,Western Athletic,,Idaho,2010,N,N
13,6,0,7,Big Ten,,Illinois,2010,N,N
12,7,0,5,Big Ten,,Indiana,2010,N,N
13,5,0,8,Big Ten,,Iowa,2010,N,N
12,7,0,5,Big 12,North,Iowa State,2010,N,N
12,9,0,3,Big 12,North,Kansas,2010,N,N
13,6,0,7,Big 12,North,Kansas State,2010,N,N
12,7,0,5,Mid-American,East,Kent State,2010,N,N
13,7,0,6,SEC,East,Kentucky,2010,N,N
12,9,0,3,Sun Belt,East,Louisiana,2010,N,N
12,7,0,5,Sun Belt,East,Louisiana Monroe,2010,N,N
12,7,0,5,Western Athletic,,Louisiana Tech,2010,N,N
13,6,0,7,Big East,,Louisville,2010,N,N
13,2,0,11,SEC,West,LSU,2010,N,N
12,7,0,5,Conference USA,East,Marshall,2010,N,N
13,4,0,9,ACC,Atlantic,Maryland,2010,N,N
12,11,0,1,Conference USA,East,Memphis,2010,N,N
13,6,0,7,ACC,Coastal,Miami,2010,N,N
14,4,0,10,Mid-American,East,Miami (OH),2010,N,N
13,6,0,7,Big Ten,,Michigan,2010,N,N
13,2,0,11,Big Ten,,Michigan State,2010,N,N
13,7,0,6,Sun Belt,,Middle Tennessee,2010,N,N
12,9,0,3,Big Ten,,Minnesota,2010,N,N
13,4,0,9,SEC,West,Mississippi State,2010,N,N
13,3,0,10,Big 12,North,Missouri,2010,N,N
13,4,0,9,FBS Independents,,Navy,2010,N,N
13,4,0,9,ACC,Atlantic,NC State,2010,N,N
14,4,0,10,Big 12,North,Nebraska,2010,N,N
14,1,0,13,Western Athletic,,Nevada,2010,N,N
12,11,0,1,Mountain West,,New Mexico,2010,N,N
12,10,0,2,Western Athletic,,New Mexico State,2010,N,N
13,5,0,8,ACC,Coastal,North Carolina,2010,N,N
14,3,0,11,Mid-American,West,Northern Illinois,2010,N,N
12,9,0,3,Sun Belt,,North Texas,2010,N,N
13,6,0,7,Big Ten,,Northwestern,2010,N,N
13,5,0,8,FBS Independents,,Notre Dame,2010,N,N
13,5,0,8,Mid-American,East,Ohio,2010,N,N
13,1,0,12,Big Ten,,Ohio State,2010,N,N
14,2,0,12,Big 12,South,Oklahoma,2010,N,N
13,2,0,11,Big 12,South,Oklahoma State,2010,N,N
12,8,0,4,SEC,West,Ole Miss,2010,N,N
13,1,0,12,Pac-10,,Oregon,2010,N,Y
12,7,0,5,Pac-10,,Oregon State,2010,N,N
13,6,0,7,Big Ten,,Penn State,2010,N,N
13,5,0,8,Big East,,Pittsburgh,2010,N,N
12,8,0,4,Big Ten,,Purdue,2010,N,N
12,8,0,4,Conference USA,West,Rice,2010,N,N
12,8,0,4,Big East,,Rutgers,2010,N,N
13,4,0,9,Mountain West,,San Diego State,2010,N,N
13,12,0,1,Western Athletic,,San Josï¿½ State,2010,N,N
14,7,0,7,Conference USA,West,SMU,2010,N,N
14,5,0,9,SEC,East,South Carolina,2010,N,N
13,5,0,8,Conference USA,East,Southern Mississippi,2010,N,N
13,5,0,8,Big East,,South Florida,2010,N,N
13,1,0,12,Pac-10,,Stanford,2010,N,N
13,5,0,8,Big East,,Syracuse,2010,N,N
13,0,0,13,Mountain West,,TCU,2010,N,N
12,4,0,8,Mid-American,East,Temple,2010,N,N
13,7,0,6,SEC,East,Tennessee,2010,N,N
12,7,0,5,Big 12,South,Texas,2010,N,N
13,4,0,9,Big 12,South,Texas A&M,2010,N,N
13,5,0,8,Big 12,South,Texas Tech,2010,N,N
13,5,0,8,Mid-American,West,Toledo,2010,N,N
13,5,0,8,Sun Belt,East,Troy,2010,N,N
12,8,0,4,Conference USA,West,Tulane,2010,N,N
13,3,0,10,Conference USA,West,Tulsa,2010,N,N
12,8,0,4,Conference USA,East,UAB,2010,N,N
14,3,0,11,Conference USA,East,UCF,2010,N,N
12,8,0,4,Pac-10,,UCLA,2010,N,N
13,11,0,2,Mountain West,,UNLV,2010,N,N
13,5,0,8,Pac-10,,USC,2010,N,N
13,3,0,10,Mountain West,,Utah,2010,N,N
12,8,0,4,Western Athletic,,Utah State,2010,N,N
13,7,0,6,Conference USA,West,UTEP,2010,N,N
12,10,0,2,SEC,East,Vanderbilt,2010,N,N
12,8,0,4,ACC,Coastal,Virginia,2010,N,N
14,3,0,11,ACC,Coastal,Virginia Tech,2010,N,N
12,9,0,3,ACC,Atlantic,Wake Forest,2010,N,N
13,6,0,7,Pac-10,,Washington,2010,N,N
12,10,0,2,Pac-10,,Washington State,2010,N,N
12,10,0,2,Sun Belt,,Western Kentucky,2010,N,N
12,6,0,6,Mid-American,West,Western Michigan,2010,N,N
13,4,0,9,Big East,,West Virginia,2010,N,N
13,2,0,11,Big Ten,,Wisconsin,2010,N,N
12,9,0,3,Mountain West,,Wyoming,2010,N,N
13,6,0,7,Mountain West,,Air Force,2011,N,N
12,11,0,1,Mid-American,East,Akron,2011,N,N
13,1,0,12,SEC,West,Alabama,2011,Y,N
12,8,0,4,Pac-12,South,Arizona,2011,N,N
13,7,0,6,Pac-12,South,Arizona State,2011,N,N
13,2,0,11,SEC,West,Arkansas,2011,N,N
13,3,0,10,Sun Belt,East,Arkansas State,2011,N,N
12,9,0,3,FBS Independents,,Army,2011,N,N
13,5,0,8,SEC,West,Auburn,2011,N,N
12,6,0,6,Mid-American,West,Ball State,2011,N,N
13,3,0,10,Big 12,,Baylor,2011,N,N
13,1,0,12,Mountain West,,Boise State,2011,N,N
12,8,0,4,ACC,Atlantic,Boston College,2011,N,N
12,7,0,5,Mid-American,East,Bowling Green,2011,N,N
12,9,0,3,Mid-American,East,Buffalo,2011,N,N
13,3,0,10,FBS Independents,,BYU,2011,N,N
13,6,0,7,Pac-12,North,California,2011,N,N
12,9,0,3,Mid-American,West,Central Michigan,2011,N,N
13,3,0,10,Big East,,Cincinnati,2011,N,N
14,4,0,10,ACC,Atlantic,Clemson,2011,N,N
13,10,0,3,Pac-12,South,Colorado,2011,N,N
12,9,0,3,Mountain West,,Colorado State,2011,N,N
12,7,0,5,Big East,,Connecticut,2011,N,N
12,9,0,3,ACC,Coastal,Duke,2011,N,N
12,7,0,5,Conference USA,East,East Carolina,2011,N,N
12,6,0,6,Mid-American,West,Eastern Michigan,2011,N,N
13,6,0,7,SEC,East,Florida,2011,N,N
12,11,0,1,Sun Belt,,Florida Atlantic,2011,N,N
13,5,0,8,Sun Belt,,Florida International,2011,N,N
13,4,0,9,ACC,Atlantic,Florida State,2011,N,N
13,9,0,4,Western Athletic,,Fresno State,2011,N,N
14,4,0,10,SEC,East,Georgia,2011,N,N
13,5,0,8,ACC,Coastal,Georgia Tech,2011,N,N
13,7,0,6,Western Athletic,,Hawai'i,2011,N,N
14,1,0,13,Conference USA,West,Houston,2011,N,N
12,10,0,2,Western Athletic,,Idaho,2011,N,N
13,6,0,7,Big Ten,Leaders,Illinois,2011,N,N
12,11,0,1,Big Ten,Leaders,Indiana,2011,N,N
13,6,0,7,Big Ten,Legends,Iowa,2011,N,N
13,7,0,6,Big 12,,Iowa State,2011,N,N
12,10,0,2,Big 12,,Kansas,2011,N,N
13,3,0,10,Big 12,,Kansas State,2011,N,N
12,7,0,5,Mid-American,East,Kent State,2011,N,N
12,7,0,5,SEC,East,Kentucky,2011,N,N
13,4,0,9,Sun Belt,East,Louisiana,2011,N,N
12,8,0,4,Sun Belt,East,Louisiana Monroe,2011,N,N
13,5,0,8,Western Athletic,,Louisiana Tech,2011,N,N
13,6,0,7,Big East,,Louisville,2011,N,N
14,1,0,13,SEC,West,LSU,2011,N,Y
13,6,0,7,Conference USA,East,Marshall,2011,N,N
12,10,0,2,ACC,Atlantic,Maryland,2011,N,N
12,10,0,2,Conference USA,East,Memphis,2011,N,N
12,6,0,6,ACC,Coastal,Miami,2011,N,N
12,8,0,4,Mid-American,East,Miami (OH),2011,N,N
13,2,0,11,Big Ten,Legends,Michigan,2011,N,N
14,3,0,11,Big Ten,Legends,Michigan State,2011,N,N
12,10,0,2,Sun Belt,,Middle Tennessee,2011,N,N
12,9,0,3,Big Ten,Legends,Minnesota,2011,N,N
13,6,0,7,SEC,West,Mississippi State,2011,N,N
13,5,0,8,Big 12,,Missouri,2011,N,N
12,7,0,5,FBS Independents,,Navy,2011,N,N
13,5,0,8,ACC,Atlantic,NC State,2011,N,N
13,4,0,9,Big Ten,Legends,Nebraska,2011,N,N
13,6,0,7,Western Athletic,,Nevada,2011,N,N
12,11,0,1,Mountain West,,New Mexico,2011,N,N
13,9,0,4,Western Athletic,,New Mexico State,2011,N,N
13,6,0,7,ACC,Coastal,North Carolina,2011,N,N
14,3,0,11,Mid-American,West,Northern Illinois,2011,N,N
12,7,0,5,Sun Belt,,North Texas,2011,N,N
13,7,0,6,Big Ten,Legends,Northwestern,2011,N,N
13,5,0,8,FBS Independents,,Notre Dame,2011,N,N
14,4,0,10,Mid-American,East,Ohio,2011,N,N
13,7,0,6,Big Ten,Leaders,Ohio State,2011,N,N
13,3,0,10,Big 12,,Oklahoma,2011,N,N
13,1,0,12,Big 12,,Oklahoma State,2011,N,N
12,10,0,2,SEC,West,Ole Miss,2011,N,N
14,2,0,12,Pac-12,North,Oregon,2011,N,N
12,9,0,3,Pac-12,North,Oregon State,2011,N,N
13,4,0,9,Big Ten,Leaders,Penn State,2011,N,N
13,7,0,6,Big East,,Pittsburgh,2011,N,N
13,6,0,7,Big Ten,Leaders,Purdue,2011,N,N
12,8,0,4,Conference USA,West,Rice,2011,N,N
13,4,0,9,Big East,,Rutgers,2011,N,N
13,5,0,8,Mountain West,,San Diego State,2011,N,N
12,7,0,5,Western Athletic,,San Josï¿½ State,2011,N,N
13,5,0,8,Conference USA,West,SMU,2011,N,N
13,2,0,11,SEC,East,South Carolina,2011,N,N
14,2,0,12,Conference USA,East,Southern Mississippi,2011,N,N
12,7,0,5,Big East,,South Florida,2011,N,N
13,2,0,11,Pac-12,North,Stanford,2011,N,N
12,7,0,5,Big East,,Syracuse,2011,N,N
13,2,0,11,Mountain West,,TCU,2011,N,N
13,4,0,9,Mid-American,East,Temple,2011,N,N
12,7,0,5,SEC,East,Tennessee,2011,N,N
13,5,0,8,Big 12,,Texas,2011,N,N
13,6,0,7,Big 12,,Texas A&M,2011,N,N
12,7,0,5,Big 12,,Texas Tech,2011,N,N
13,4,0,9,Mid-American,West,Toledo,2011,N,N
12,9,0,3,Sun Belt,East,Troy,2011,N,N
13,11,0,2,Conference USA,West,Tulane,2011,N,N
13,5,0,8,Conference USA,West,Tulsa,2011,N,N
12,9,0,3,Conference USA,East,UAB,2011,N,N
12,7,0,5,Conference USA,East,UCF,2011,N,N
14,8,0,6,Pac-12,South,UCLA,2011,N,N
12,10,0,2,Mountain West,,UNLV,2011,N,N
12,2,0,10,Pac-12,South,USC,2011,N,N
13,5,0,8,Pac-12,South,Utah,2011,N,N
13,6,0,7,Western Athletic,,Utah State,2011,N,N
12,7,0,5,Conference USA,West,UTEP,2011,N,N
13,7,0,6,SEC,East,Vanderbilt,2011,N,N
13,5,0,8,ACC,Coastal,Virginia,2011,N,N
14,3,0,11,ACC,Coastal,Virginia Tech,2011,N,N
13,7,0,6,ACC,Atlantic,Wake Forest,2011,N,N
13,6,0,7,Pac-12,North,Washington,2011,N,N
12,8,0,4,Pac-12,North,Washington State,2011,N,N
12,5,0,7,Sun Belt,,Western Kentucky,2011,N,N
13,6,0,7,Mid-American,West,Western Michigan,2011,N,N
13,3,0,10,Big East,,West Virginia,2011,N,N
14,3,0,11,Big Ten,Leaders,Wisconsin,2011,N,N
13,5,0,8,Mountain West,,Wyoming,2011,N,N
13,7,0,6,Mountain West,,Air Force,2012,N,N
12,11,0,1,Mid-American,East,Akron,2012,N,N
14,1,0,13,SEC,West,Alabama,2012,Y,N
13,5,0,8,Pac-12,South,Arizona,2012,N,N
13,5,0,8,Pac-12,South,Arizona State,2012,N,N
12,8,0,4,SEC,West,Arkansas,2012,N,N
13,3,0,10,Sun Belt,East,Arkansas State,2012,N,N
12,10,0,2,FBS Independents,,Army,2012,N,N
12,9,0,3,SEC,West,Auburn,2012,N,N
13,4,0,9,Mid-American,West,Ball State,2012,N,N
13,5,0,8,Big 12,,Baylor,2012,N,N
13,2,0,11,Mountain West,,Boise State,2012,N,N
12,10,0,2,ACC,Atlantic,Boston College,2012,N,N
13,5,0,8,Mid-American,East,Bowling Green,2012,N,N
12,8,0,4,Mid-American,East,Buffalo,2012,N,N
13,5,0,8,FBS Independents,,BYU,2012,N,N
12,9,0,3,Pac-12,North,California,2012,N,N
13,6,0,7,Mid-American,West,Central Michigan,2012,N,N
13,3,0,10,Big East,,Cincinnati,2012,N,N
13,2,0,11,ACC,Atlantic,Clemson,2012,N,N
12,11,0,1,Pac-12,South,Colorado,2012,N,N
12,8,0,4,Mountain West,,Colorado State,2012,N,N
12,7,0,5,Big East,,Connecticut,2012,N,N
13,7,0,6,ACC,Coastal,Duke,2012,N,N
13,5,0,8,Conference USA,East,East Carolina,2012,N,N
12,10,0,2,Mid-American,West,Eastern Michigan,2012,N,N
13,2,0,11,SEC,East,Florida,2012,N,N
12,9,0,3,Sun Belt,,Florida Atlantic,2012,N,N
12,9,0,3,Sun Belt,,Florida International,2012,N,N
14,2,0,12,ACC,Atlantic,Florida State,2012,N,N
13,4,0,9,Mountain West,,Fresno State,2012,N,N
14,2,0,12,SEC,East,Georgia,2012,N,N
14,7,0,7,ACC,Coastal,Georgia Tech,2012,N,N
12,9,0,3,Mountain West,,Hawai'i,2012,N,N
12,7,0,5,Conference USA,West,Houston,2012,N,N
12,11,0,1,Western Athletic,,Idaho,2012,N,N
12,10,0,2,Big Ten,Leaders,Illinois,2012,N,N
12,8,0,4,Big Ten,Leaders,Indiana,2012,N,N
12,8,0,4,Big Ten,Legends,Iowa,2012,N,N
13,7,0,6,Big 12,,Iowa State,2012,N,N
12,11,0,1,Big 12,,Kansas,2012,N,N
13,2,0,11,Big 12,,Kansas State,2012,N,N
14,3,0,11,Mid-American,East,Kent State,2012,N,N
12,10,0,2,SEC,East,Kentucky,2012,N,N
13,4,0,9,Sun Belt,East,Louisiana,2012,N,N
13,5,0,8,Sun Belt,East,Louisiana Monroe,2012,N,N
12,3,0,9,Western Athletic,,Louisiana Tech,2012,N,N
13,2,0,11,Big East,,Louisville,2012,N,N
13,3,0,10,SEC,West,LSU,2012,N,N
12,7,0,5,Conference USA,East,Marshall,2012,N,N
12,8,0,4,ACC,Atlantic,Maryland,2012,N,N
12,8,0,4,Conference USA,East,Memphis,2012,N,N
12,5,0,7,ACC,Coastal,Miami,2012,N,N
12,8,0,4,Mid-American,East,Miami (OH),2012,N,N
13,5,0,8,Big Ten,Legends,Michigan,2012,N,N
13,6,0,7,Big Ten,Legends,Michigan State,2012,N,N
12,4,0,8,Sun Belt,,Middle Tennessee,2012,N,N
13,7,0,6,Big Ten,Legends,Minnesota,2012,N,N
13,5,0,8,SEC,West,Mississippi State,2012,N,N
12,7,0,5,SEC,East,Missouri,2012,N,N
13,5,0,8,FBS Independents,,Navy,2012,N,N
13,6,0,7,ACC,Atlantic,NC State,2012,N,N
14,4,0,10,Big Ten,Legends,Nebraska,2012,N,N
13,6,0,7,Mountain West,,Nevada,2012,N,N
13,9,0,4,Mountain West,,New Mexico,2012,N,N
12,11,0,1,Western Athletic,,New Mexico State,2012,N,N
12,4,0,8,ACC,Coastal,North Carolina,2012,N,N
14,2,0,12,Mid-American,West,Northern Illinois,2012,N,N
12,8,0,4,Sun Belt,,North Texas,2012,N,N
13,3,0,10,Big Ten,Legends,Northwestern,2012,N,N
13,1,0,12,FBS Independents,,Notre Dame,2012,N,Y
13,4,0,9,Mid-American,East,Ohio,2012,N,N
12,0,0,12,Big Ten,Leaders,Ohio State,2012,N,N
13,3,0,10,Big 12,,Oklahoma,2012,N,N
13,5,0,8,Big 12,,Oklahoma State,2012,N,N
13,6,0,7,SEC,West,Ole Miss,2012,N,N
13,1,0,12,Pac-12,North,Oregon,2012,N,N
13,4,0,9,Pac-12,North,Oregon State,2012,N,N
12,4,0,8,Big Ten,Leaders,Penn State,2012,N,N
13,7,0,6,Big East,,Pittsburgh,2012,N,N
13,7,0,6,Big Ten,Leaders,Purdue,2012,N,N
13,6,0,7,Conference USA,West,Rice,2012,N,N
13,4,0,9,Big East,,Rutgers,2012,N,N
13,4,0,9,Mountain West,,San Diego State,2012,N,N
13,2,0,11,Western Athletic,,San Josï¿½ State,2012,N,N
13,6,0,7,Conference USA,West,SMU,2012,N,N
13,11,0,2,Sun Belt,East,South Alabama,2012,N,N
13,2,0,11,SEC,East,South Carolina,2012,N,N
12,12,0,0,Conference USA,East,Southern Mississippi,2012,N,N
12,9,0,3,Big East,,South Florida,2012,N,N
14,2,0,12,Pac-12,North,Stanford,2012,N,N
13,5,0,8,Big East,,Syracuse,2012,N,N
13,6,0,7,Big 12,,TCU,2012,N,N
11,7,0,4,Big East,,Temple,2012,N,N
12,7,0,5,SEC,East,Tennessee,2012,N,N
13,4,0,9,Big 12,,Texas,2012,N,N
13,2,0,11,SEC,West,Texas A&M,2012,N,N
12,8,0,4,Western Athletic,,Texas State,2012,N,N
13,5,0,8,Big 12,,Texas Tech,2012,N,N
13,4,0,9,Mid-American,West,Toledo,2012,N,N
12,7,0,5,Sun Belt,East,Troy,2012,N,N
12,10,0,2,Conference USA,West,Tulane,2012,N,N
14,3,0,11,Conference USA,West,Tulsa,2012,N,N
12,9,0,3,Conference USA,East,UAB,2012,N,N
14,4,0,10,Conference USA,East,UCF,2012,N,N
14,5,0,9,Pac-12,South,UCLA,2012,N,N
12,11,0,1,Mid-American,East,UMass,2012,N,N
13,11,0,2,Mountain West,,UNLV,2012,N,N
13,6,0,7,Pac-12,South,USC,2012,N,N
12,7,0,5,Pac-12,South,Utah,2012,N,N
13,2,0,11,Western Athletic,,Utah State,2012,N,N
12,9,0,3,Conference USA,West,UTEP,2012,N,N
12,4,0,8,Western Athletic,,UT San Antonio,2012,N,N
13,4,0,9,SEC,East,Vanderbilt,2012,N,N
12,8,0,4,ACC,Coastal,Virginia,2012,N,N
13,6,0,7,ACC,Coastal,Virginia Tech,2012,N,N
12,7,0,5,ACC,Atlantic,Wake Forest,2012,N,N
13,6,0,7,Pac-12,North,Washington,2012,N,N
12,9,0,3,Pac-12,North,Washington State,2012,N,N
13,6,0,7,Sun Belt,,Western Kentucky,2012,N,N
12,8,0,4,Mid-American,West,Western Michigan,2012,N,N
13,6,0,7,Big 12,,West Virginia,2012,N,N
14,6,0,8,Big Ten,Leaders,Wisconsin,2012,N,N
12,8,0,4,Mountain West,,Wyoming,2012,N,N
12,10,0,2,Mountain West,Mountain,Air Force,2013,N,N
12,7,0,5,Mid-American,East,Akron,2013,N,N
13,2,0,11,SEC,West,Alabama,2013,N,N
13,5,0,8,Pac-12,South,Arizona,2013,N,N
14,4,0,10,Pac-12,South,Arizona State,2013,N,N
12,9,0,3,SEC,West,Arkansas,2013,N,N
13,5,0,8,Sun Belt,East,Arkansas State,2013,N,N
12,9,0,3,FBS Independents,,Army,2013,N,N
14,2,0,12,SEC,West,Auburn,2013,N,Y
13,3,0,10,Mid-American,West,Ball State,2013,N,N
13,2,0,11,Big 12,,Baylor,2013,N,N
13,5,0,8,Mountain West,Mountain,Boise State,2013,N,N
13,6,0,7,ACC,Atlantic,Boston College,2013,N,N
14,4,0,10,Mid-American,East,Bowling Green,2013,N,N
13,5,0,8,Mid-American,East,Buffalo,2013,N,N
13,5,0,8,FBS Independents,,BYU,2013,N,N
12,11,0,1,Pac-12,North,California,2013,N,N
12,6,0,6,Mid-American,West,Central Michigan,2013,N,N
13,4,0,9,American Athletic,,Cincinnati,2013,N,N
13,2,0,11,ACC,Atlantic,Clemson,2013,N,N
12,8,0,4,Pac-12,South,Colorado,2013,N,N
14,6,0,8,Mountain West,Mountain,Colorado State,2013,N,N
12,9,0,3,American Athletic,,Connecticut,2013,N,N
14,4,0,10,ACC,Coastal,Duke,2013,N,N
13,3,0,10,Conference USA,East,East Carolina,2013,N,N
12,10,0,2,Mid-American,West,Eastern Michigan,2013,N,N
12,8,0,4,SEC,East,Florida,2013,N,N
12,6,0,6,Conference USA,East,Florida Atlantic,2013,N,N
12,11,0,1,Conference USA,East,Florida International,2013,N,N
14,0,0,14,ACC,Atlantic,Florida State,2013,Y,N
13,2,0,11,Mountain West,West,Fresno State,2013,N,N
13,5,0,8,SEC,East,Georgia,2013,N,N
12,12,0,0,Sun Belt,West,Georgia State,2013,N,N
13,6,0,7,ACC,Coastal,Georgia Tech,2013,N,N
12,11,0,1,Mountain West,West,Hawai'i,2013,N,N
13,5,0,8,American Athletic,,Houston,2013,N,N
12,11,0,1,FBS Independents,,Idaho,2013,N,N
12,8,0,4,Big Ten,Leaders,Illinois,2013,N,N
12,7,0,5,Big Ten,Leaders,Indiana,2013,N,N
13,5,0,8,Big Ten,Legends,Iowa,2013,N,N
12,9,0,3,Big 12,,Iowa State,2013,N,N
12,9,0,3,Big 12,,Kansas,2013,N,N
13,5,0,8,Big 12,,Kansas State,2013,N,N
12,8,0,4,Mid-American,East,Kent State,2013,N,N
12,10,0,2,SEC,East,Kentucky,2013,N,N
13,4,0,9,Sun Belt,East,Louisiana,2013,N,N
12,6,0,6,Sun Belt,East,Louisiana Monroe,2013,N,N
12,8,0,4,Conference USA,West,Louisiana Tech,2013,N,N
13,1,0,12,American Athletic,,Louisville,2013,N,N
13,3,0,10,SEC,West,LSU,2013,N,N
14,4,0,10,Conference USA,East,Marshall,2013,N,N
13,6,0,7,ACC,Atlantic,Maryland,2013,N,N
12,9,0,3,American Athletic,,Memphis,2013,N,N
13,4,0,9,ACC,Coastal,Miami,2013,N,N
12,12,0,0,Mid-American,East,Miami (OH),2013,N,N
13,6,0,7,Big Ten,Legends,Michigan,2013,N,N
14,1,0,13,Big Ten,Legends,Michigan State,2013,N,N
13,5,0,8,Conference USA,East,Middle Tennessee,2013,N,N
13,5,0,8,Big Ten,Legends,Minnesota,2013,N,N
13,6,0,7,SEC,West,Mississippi State,2013,N,N
14,2,0,12,SEC,East,Missouri,2013,N,N
13,4,0,9,FBS Independents,,Navy,2013,N,N
12,9,0,3,ACC,Atlantic,NC State,2013,N,N
13,4,0,9,Big Ten,Legends,Nebraska,2013,N,N
12,8,0,4,Mountain West,West,Nevada,2013,N,N
12,9,0,3,Mountain West,Mountain,New Mexico,2013,N,N
12,10,0,2,FBS Independents,,New Mexico State,2013,N,N
13,6,0,7,ACC,Coastal,North Carolina,2013,N,N
14,2,0,12,Mid-American,West,Northern Illinois,2013,N,N
13,4,0,9,Conference USA,West,North Texas,2013,N,N
12,7,0,5,Big Ten,Legends,Northwestern,2013,N,N
13,4,0,9,FBS Independents,,Notre Dame,2013,N,N
13,6,0,7,Mid-American,East,Ohio,2013,N,N
14,2,0,12,Big Ten,Leaders,Ohio State,2013,N,N
13,2,0,11,Big 12,,Oklahoma,2013,N,N
13,3,0,10,Big 12,,Oklahoma State,2013,N,N
13,5,0,8,SEC,West,Ole Miss,2013,N,N
13,2,0,11,Pac-12,North,Oregon,2013,N,N
13,6,0,7,Pac-12,North,Oregon State,2013,N,N
12,5,0,7,Big Ten,Leaders,Penn State,2013,N,N
13,6,0,7,ACC,Coastal,Pittsburgh,2013,N,N
12,11,0,1,Big Ten,Leaders,Purdue,2013,N,N
14,4,0,10,Conference USA,West,Rice,2013,N,N
13,7,0,6,American Athletic,,Rutgers,2013,N,N
13,5,0,8,Mountain West,West,San Diego State,2013,N,N
12,6,0,6,Mountain West,West,San Josï¿½ State,2013,N,N
12,7,0,5,American Athletic,,SMU,2013,N,N
12,6,0,6,Sun Belt,East,South Alabama,2013,N,N
13,2,0,11,SEC,East,South Carolina,2013,N,N
12,11,0,1,Conference USA,East,Southern Mississippi,2013,N,N
12,10,0,2,American Athletic,,South Florida,2013,N,N
14,3,0,11,Pac-12,North,Stanford,2013,N,N
13,6,0,7,ACC,Atlantic,Syracuse,2013,N,N
12,8,0,4,Big 12,,TCU,2013,N,N
12,10,0,2,American Athletic,,Temple,2013,N,N
12,7,0,5,SEC,East,Tennessee,2013,N,N
13,5,0,8,Big 12,,Texas,2013,N,N
13,4,0,9,SEC,West,Texas A&M,2013,N,N
12,6,0,6,Sun Belt,East,Texas State,2013,N,N
13,5,0,8,Big 12,,Texas Tech,2013,N,N
12,5,0,7,Mid-American,West,Toledo,2013,N,N
12,6,0,6,Sun Belt,East,Troy,2013,N,N
13,6,0,7,Conference USA,West,Tulane,2013,N,N
12,9,0,3,Conference USA,West,Tulsa,2013,N,N
12,10,0,2,Conference USA,East,UAB,2013,N,N
13,1,0,12,American Athletic,,UCF,2013,N,N
13,3,0,10,Pac-12,South,UCLA,2013,N,N
12,11,0,1,Mid-American,East,UMass,2013,N,N
13,6,0,7,Mountain West,West,UNLV,2013,N,N
14,4,0,10,Pac-12,South,USC,2013,N,N
12,7,0,5,Pac-12,South,Utah,2013,N,N
14,5,0,9,Mountain West,Mountain,Utah State,2013,N,N
12,10,0,2,Conference USA,West,UTEP,2013,N,N
12,5,0,7,Conference USA,West,UT San Antonio,2013,N,N
13,4,0,9,SEC,East,Vanderbilt,2013,N,N
12,10,0,2,ACC,Coastal,Virginia,2013,N,N
13,5,0,8,ACC,Coastal,Virginia Tech,2013,N,N
12,8,0,4,ACC,Atlantic,Wake Forest,2013,N,N
13,4,0,9,Pac-12,North,Washington,2013,N,N
13,7,0,6,Pac-12,North,Washington State,2013,N,N
12,4,0,8,Sun Belt,,Western Kentucky,2013,N,N
12,11,0,1,Mid-American,West,Western Michigan,2013,N,N
12,8,0,4,Big 12,,West Virginia,2013,N,N
13,4,0,9,Big Ten,Leaders,Wisconsin,2013,N,N
12,7,0,5,Mountain West,Mountain,Wyoming,2013,N,N
13,3,0,10,Mountain West,Mountain,Air Force,2014,N,N
12,7,0,5,Mid-American,East,Akron,2014,N,N
14,2,0,12,SEC,West,Alabama,2014,N,N
12,5,0,7,Sun Belt,West,Appalachian State,2014,N,N
14,4,0,10,Pac-12,South,Arizona,2014,N,N
13,3,0,10,Pac-12,South,Arizona State,2014,N,N
13,6,0,7,SEC,West,Arkansas,2014,N,N
13,6,0,7,Sun Belt,East,Arkansas State,2014,N,N
12,8,0,4,FBS Independents,,Army,2014,N,N
13,5,0,8,SEC,West,Auburn,2014,N,N
12,7,0,5,Mid-American,West,Ball State,2014,N,N
13,2,0,11,Big 12,,Baylor,2014,N,N
14,2,0,12,Mountain West,Mountain,Boise State,2014,N,N
13,6,0,7,ACC,Atlantic,Boston College,2014,N,N
14,6,0,8,Mid-American,East,Bowling Green,2014,N,N
11,6,0,5,Mid-American,East,Buffalo,2014,N,N
13,5,0,8,FBS Independents,,BYU,2014,N,N
12,7,0,5,Pac-12,North,California,2014,N,N
13,6,0,7,Mid-American,West,Central Michigan,2014,N,N
13,4,0,9,American Athletic,,Cincinnati,2014,N,N
13,3,0,10,ACC,Atlantic,Clemson,2014,N,N
12,10,0,2,Pac-12,South,Colorado,2014,N,N
13,3,0,10,Mountain West,Mountain,Colorado State,2014,N,N
12,10,0,2,American Athletic,,Connecticut,2014,N,N
13,4,0,9,ACC,Coastal,Duke,2014,N,N
13,5,0,8,American Athletic,,East Carolina,2014,N,N
12,10,0,2,Mid-American,West,Eastern Michigan,2014,N,N
12,5,0,7,SEC,East,Florida,2014,N,N
12,9,0,3,Conference USA,East,Florida Atlantic,2014,N,N
12,8,0,4,Conference USA,East,Florida International,2014,N,N
14,1,0,13,ACC,Atlantic,Florida State,2014,N,N
14,8,0,6,Mountain West,West,Fresno State,2014,N,N
13,3,0,10,SEC,East,Georgia,2014,N,N
12,3,0,9,Sun Belt,West,Georgia Southern,2014,N,N
12,11,0,1,Sun Belt,West,Georgia State,2014,N,N
14,3,0,11,ACC,Coastal,Georgia Tech,2014,N,N
13,9,0,4,Mountain West,West,Hawai'i,2014,N,N
13,5,0,8,American Athletic,,Houston,2014,N,N
11,10,0,1,Sun Belt,,Idaho,2014,N,N
13,7,0,6,Big Ten,West,Illinois,2014,N,N
12,8,0,4,Big Ten,East,Indiana,2014,N,N
13,6,0,7,Big Ten,West,Iowa,2014,N,N
12,10,0,2,Big 12,,Iowa State,2014,N,N
12,9,0,3,Big 12,,Kansas,2014,N,N
13,4,0,9,Big 12,,Kansas State,2014,N,N
11,9,0,2,Mid-American,East,Kent State,2014,N,N
12,7,0,5,SEC,East,Kentucky,2014,N,N
13,4,0,9,Sun Belt,East,Louisiana,2014,N,N
12,8,0,4,Sun Belt,East,Louisiana Monroe,2014,N,N
14,5,0,9,Conference USA,West,Louisiana Tech,2014,N,N
13,4,0,9,ACC,Atlantic,Louisville,2014,N,N
13,5,0,8,SEC,West,LSU,2014,N,N
14,1,0,13,Conference USA,East,Marshall,2014,N,N
13,6,0,7,Big Ten,East,Maryland,2014,N,N
13,3,0,10,American Athletic,,Memphis,2014,N,N
13,7,0,6,ACC,Coastal,Miami,2014,N,N
12,10,0,2,Mid-American,East,Miami (OH),2014,N,N
12,7,0,5,Big Ten,East,Michigan,2014,N,N
13,2,0,11,Big Ten,East,Michigan State,2014,N,N
12,6,0,6,Conference USA,East,Middle Tennessee,2014,N,N
13,5,0,8,Big Ten,West,Minnesota,2014,N,N
13,3,0,10,SEC,West,Mississippi State,2014,N,N
14,3,0,11,SEC,East,Missouri,2014,N,N
13,5,0,8,FBS Independents,,Navy,2014,N,N
13,5,0,8,ACC,Atlantic,NC State,2014,N,N
13,4,0,9,Big Ten,West,Nebraska,2014,N,N
13,6,0,7,Mountain West,West,Nevada,2014,N,N
12,8,0,4,Mountain West,Mountain,New Mexico,2014,N,N
12,10,0,2,Sun Belt,,New Mexico State,2014,N,N
13,7,0,6,ACC,Coastal,North Carolina,2014,N,N
14,3,0,11,Mid-American,West,Northern Illinois,2014,N,N
12,8,0,4,Conference USA,West,North Texas,2014,N,N
12,7,0,5,Big Ten,West,Northwestern,2014,N,N
13,5,0,8,FBS Independents,,Notre Dame,2014,N,N
12,6,0,6,Mid-American,East,Ohio,2014,N,N
15,1,0,14,Big Ten,East,Ohio State,2014,Y,N
13,5,0,8,Big 12,,Oklahoma,2014,N,N
13,6,0,7,Big 12,,Oklahoma State,2014,N,N
12,6,0,6,Conference USA,East,Old Dominion,2014,N,N
13,4,0,9,SEC,West,Ole Miss,2014,N,N
15,2,0,13,Pac-12,North,Oregon,2014,N,Y
12,7,0,5,Pac-12,North,Oregon State,2014,N,N
13,6,0,7,Big Ten,East,Penn State,2014,N,N
13,7,0,6,ACC,Coastal,Pittsburgh,2014,N,N
12,9,0,3,Big Ten,West,Purdue,2014,N,N
13,5,0,8,Conference USA,West,Rice,2014,N,N
13,5,0,8,Big Ten,East,Rutgers,2014,N,N
13,6,0,7,Mountain West,West,San Diego State,2014,N,N
12,9,0,3,Mountain West,West,San Josï¿½ State,2014,N,N
12,11,0,1,American Athletic,,SMU,2014,N,N
13,7,0,6,Sun Belt,East,South Alabama,2014,N,N
13,6,0,7,SEC,East,South Carolina,2014,N,N
12,9,0,3,Conference USA,West,Southern Mississippi,2014,N,N
12,8,0,4,American Athletic,,South Florida,2014,N,N
13,5,0,8,Pac-12,North,Stanford,2014,N,N
12,9,0,3,ACC,Atlantic,Syracuse,2014,N,N
13,1,0,12,Big 12,,TCU,2014,N,N
12,6,0,6,American Athletic,,Temple,2014,N,N
13,6,0,7,SEC,East,Tennessee,2014,N,N
13,7,0,6,Big 12,,Texas,2014,N,N
13,5,0,8,SEC,West,Texas A&M,2014,N,N
12,5,0,7,Sun Belt,East,Texas State,2014,N,N
12,8,0,4,Big 12,,Texas Tech,2014,N,N
13,4,0,9,Mid-American,West,Toledo,2014,N,N
12,9,0,3,Sun Belt,East,Troy,2014,N,N
12,9,0,3,American Athletic,,Tulane,2014,N,N
12,10,0,2,American Athletic,,Tulsa,2014,N,N
12,6,0,6,Conference USA,East,UAB,2014,N,N
13,4,0,9,American Athletic,,UCF,2014,N,N
13,3,0,10,Pac-12,South,UCLA,2014,N,N
12,9,0,3,Mid-American,East,UMass,2014,N,N
13,11,0,2,Mountain West,West,UNLV,2014,N,N
13,4,0,9,Pac-12,South,USC,2014,N,N
13,4,0,9,Pac-12,South,Utah,2014,N,N
14,4,0,10,Mountain West,Mountain,Utah State,2014,N,N
13,6,0,7,Conference USA,West,UTEP,2014,N,N
12,8,0,4,Conference USA,West,UT San Antonio,2014,N,N
12,9,0,3,SEC,East,Vanderbilt,2014,N,N
12,7,0,5,ACC,Coastal,Virginia,2014,N,N
13,6,0,7,ACC,Coastal,Virginia Tech,2014,N,N
12,9,0,3,ACC,Atlantic,Wake Forest,2014,N,N
14,6,0,8,Pac-12,North,Washington,2014,N,N
12,9,0,3,Pac-12,North,Washington State,2014,N,N
13,5,0,8,Conference USA,East,Western Kentucky,2014,N,N
13,5,0,8,Mid-American,West,Western Michigan,2014,N,N
13,6,0,7,Big 12,,West Virginia,2014,N,N
14,3,0,11,Big Ten,West,Wisconsin,2014,N,N
12,8,0,4,Mountain West,Mountain,Wyoming,2014,N,N
14,6,0,8,Mountain West,Mountain,Air Force,2015,N,N
13,5,0,8,Mid-American,East,Akron,2015,N,N
15,1,0,14,SEC,West,Alabama,2015,Y,N
13,2,0,11,Sun Belt,West,Appalachian State,2015,N,N
13,6,0,7,Pac-12,South,Arizona,2015,N,N
13,7,0,6,Pac-12,South,Arizona State,2015,N,N
13,5,0,8,SEC,West,Arkansas,2015,N,N
13,4,0,9,Sun Belt,East,Arkansas State,2015,N,N
12,10,0,2,FBS Independents,,Army,2015,N,N
13,6,0,7,SEC,West,Auburn,2015,N,N
12,9,0,3,Mid-American,West,Ball State,2015,N,N
13,3,0,10,Big 12,,Baylor,2015,N,N
13,4,0,9,Mountain West,Mountain,Boise State,2015,N,N
12,9,0,3,ACC,Atlantic,Boston College,2015,N,N
14,4,0,10,Mid-American,East,Bowling Green,2015,N,N
12,7,0,5,Mid-American,East,Buffalo,2015,N,N
13,4,0,9,FBS Independents,,BYU,2015,N,N
13,5,0,8,Pac-12,North,California,2015,N,N
13,6,0,7,Mid-American,West,Central Michigan,2015,N,N
12,10,0,2,Conference USA,East,Charlotte,2015,N,N
13,6,0,7,American Athletic,East,Cincinnati,2015,N,N
15,1,0,14,ACC,Atlantic,Clemson,2015,N,Y
13,9,0,4,Pac-12,South,Colorado,2015,N,N
13,6,0,7,Mountain West,Mountain,Colorado State,2015,N,N
13,7,0,6,American Athletic,East,Connecticut,2015,N,N
13,5,0,8,ACC,Coastal,Duke,2015,N,N
12,7,0,5,American Athletic,East,East Carolina,2015,N,N
12,11,0,1,Mid-American,West,Eastern Michigan,2015,N,N
14,4,0,10,SEC,East,Florida,2015,N,N
12,9,0,3,Conference USA,East,Florida Atlantic,2015,N,N
12,7,0,5,Conference USA,East,Florida International,2015,N,N
13,3,0,10,ACC,Atlantic,Florida State,2015,N,N
12,9,0,3,Mountain West,West,Fresno State,2015,N,N
13,3,0,10,SEC,East,Georgia,2015,N,N
13,4,0,9,Sun Belt,West,Georgia Southern,2015,N,N
13,7,0,6,Sun Belt,West,Georgia State,2015,N,N
12,9,0,3,ACC,Coastal,Georgia Tech,2015,N,N
13,10,0,3,Mountain West,West,Hawai'i,2015,N,N
14,1,0,13,American Athletic,West,Houston,2015,N,N
12,8,0,4,Sun Belt,,Idaho,2015,N,N
12,7,0,5,Big Ten,West,Illinois,2015,N,N
13,7,0,6,Big Ten,East,Indiana,2015,N,N
14,2,0,12,Big Ten,West,Iowa,2015,N,N
12,9,0,3,Big 12,,Iowa State,2015,N,N
12,12,0,0,Big 12,,Kansas,2015,N,N
13,7,0,6,Big 12,,Kansas State,2015,N,N
12,9,0,3,Mid-American,East,Kent State,2015,N,N
12,7,0,5,SEC,East,Kentucky,2015,N,N
12,8,0,4,Sun Belt,East,Louisiana,2015,N,N
13,11,0,2,Sun Belt,East,Louisiana Monroe,2015,N,N
13,4,0,9,Conference USA,West,Louisiana Tech,2015,N,N
13,5,0,8,ACC,Atlantic,Louisville,2015,N,N
12,3,0,9,SEC,West,LSU,2015,N,N
13,3,0,10,Conference USA,East,Marshall,2015,N,N
12,9,0,3,Big Ten,East,Maryland,2015,N,N
13,4,0,9,American Athletic,West,Memphis,2015,N,N
13,5,0,8,ACC,Coastal,Miami,2015,N,N
12,9,0,3,Mid-American,East,Miami (OH),2015,N,N
13,3,0,10,Big Ten,East,Michigan,2015,N,N
14,2,0,12,Big Ten,East,Michigan State,2015,N,N
13,6,0,7,Conference USA,East,Middle Tennessee,2015,N,N
13,7,0,6,Big Ten,West,Minnesota,2015,N,N
13,4,0,9,SEC,West,Mississippi State,2015,N,N
12,7,0,5,SEC,East,Missouri,2015,N,N
13,2,0,11,American Athletic,West,Navy,2015,N,N
13,6,0,7,ACC,Atlantic,NC State,2015,N,N
13,7,0,6,Big Ten,West,Nebraska,2015,N,N
13,6,0,7,Mountain West,West,Nevada,2015,N,N
13,6,0,7,Mountain West,Mountain,New Mexico,2015,N,N
12,9,0,3,Sun Belt,,New Mexico State,2015,N,N
14,3,0,11,ACC,Coastal,North Carolina,2015,N,N
14,6,0,8,Mid-American,West,Northern Illinois,2015,N,N
12,11,0,1,Conference USA,West,North Texas,2015,N,N
13,3,0,10,Big Ten,West,Northwestern,2015,N,N
13,3,0,10,FBS Independents,,Notre Dame,2015,N,N
13,5,0,8,Mid-American,East,Ohio,2015,N,N
13,1,0,12,Big Ten,East,Ohio State,2015,N,N
13,2,0,11,Big 12,,Oklahoma,2015,N,N
13,3,0,10,Big 12,,Oklahoma State,2015,N,N
12,7,0,5,Conference USA,East,Old Dominion,2015,N,N
13,3,0,10,SEC,West,Ole Miss,2015,N,N
13,4,0,9,Pac-12,North,Oregon,2015,N,N
12,10,0,2,Pac-12,North,Oregon State,2015,N,N
13,6,0,7,Big Ten,East,Penn State,2015,N,N
13,5,0,8,ACC,Coastal,Pittsburgh,2015,N,N
12,10,0,2,Big Ten,West,Purdue,2015,N,N
12,7,0,5,Conference USA,West,Rice,2015,N,N
12,8,0,4,Big Ten,East,Rutgers,2015,N,N
14,3,0,11,Mountain West,West,San Diego State,2015,N,N
13,7,0,6,Mountain West,West,San Josï¿½ State,2015,N,N
12,10,0,2,American Athletic,West,SMU,2015,N,N
12,7,0,5,Sun Belt,East,South Alabama,2015,N,N
12,9,0,3,SEC,East,South Carolina,2015,N,N
14,5,0,9,Conference USA,West,Southern Mississippi,2015,N,N
13,5,0,8,American Athletic,East,South Florida,2015,N,N
14,2,0,12,Pac-12,North,Stanford,2015,N,N
12,8,0,4,ACC,Atlantic,Syracuse,2015,N,N
13,2,0,11,Big 12,,TCU,2015,N,N
14,4,0,10,American Athletic,East,Temple,2015,N,N
13,4,0,9,SEC,East,Tennessee,2015,N,N
12,7,0,5,Big 12,,Texas,2015,N,N
13,5,0,8,SEC,West,Texas A&M,2015,N,N
12,9,0,3,Sun Belt,East,Texas State,2015,N,N
13,6,0,7,Big 12,,Texas Tech,2015,N,N
12,2,0,10,Mid-American,West,Toledo,2015,N,N
12,8,0,4,Sun Belt,East,Troy,2015,N,N
12,9,0,3,American Athletic,West,Tulane,2015,N,N
13,7,0,6,American Athletic,West,Tulsa,2015,N,N
12,12,0,0,American Athletic,East,UCF,2015,N,N
13,5,0,8,Pac-12,South,UCLA,2015,N,N
12,9,0,3,Mid-American,East,UMass,2015,N,N
12,9,0,3,Mountain West,West,UNLV,2015,N,N
14,6,0,8,Pac-12,South,USC,2015,N,N
13,3,0,10,Pac-12,South,Utah,2015,N,N
13,7,0,6,Mountain West,Mountain,Utah State,2015,N,N
12,7,0,5,Conference USA,West,UTEP,2015,N,N
12,9,0,3,Conference USA,West,UT San Antonio,2015,N,N
12,8,0,4,SEC,East,Vanderbilt,2015,N,N
12,8,0,4,ACC,Coastal,Virginia,2015,N,N
13,6,0,7,ACC,Coastal,Virginia Tech,2015,N,N
12,9,0,3,ACC,Atlantic,Wake Forest,2015,N,N
13,6,0,7,Pac-12,North,Washington,2015,N,N
13,4,0,9,Pac-12,North,Washington State,2015,N,N
14,2,0,12,Conference USA,East,Western Kentucky,2015,N,N
13,5,0,8,Mid-American,West,Western Michigan,2015,N,N
13,5,0,8,Big 12,,West Virginia,2015,N,N
13,3,0,10,Big Ten,West,Wisconsin,2015,N,N
12,10,0,2,Mountain West,Mountain,Wyoming,2015,N,N
13,3,0,10,Mountain West,Mountain,Air Force,2016,N,N
12,7,0,5,Mid-American,East,Akron,2016,N,N
15,1,0,14,SEC,West,Alabama,2016,N,Y
13,3,0,10,Sun Belt,West,Appalachian State,2016,N,N
12,9,0,3,Pac-12,South,Arizona,2016,N,N
12,7,0,5,Pac-12,South,Arizona State,2016,N,N
13,6,0,7,SEC,West,Arkansas,2016,N,N
13,5,0,8,Sun Belt,East,Arkansas State,2016,N,N
13,5,0,8,FBS Independents,,Army,2016,N,N
13,5,0,8,SEC,West,Auburn,2016,N,N
12,8,0,4,Mid-American,West,Ball State,2016,N,N
13,6,0,7,Big 12,,Baylor,2016,N,N
13,3,0,10,Mountain West,Mountain,Boise State,2016,N,N
13,6,0,7,ACC,Atlantic,Boston College,2016,N,N
12,8,0,4,Mid-American,East,Bowling Green,2016,N,N
12,10,0,2,Mid-American,East,Buffalo,2016,N,N
13,4,0,9,FBS Independents,,BYU,2016,N,N
12,7,0,5,Pac-12,North,California,2016,N,N
13,7,0,6,Mid-American,West,Central Michigan,2016,N,N
12,8,0,4,Conference USA,East,Charlotte,2016,N,N
12,8,0,4,American Athletic,East,Cincinnati,2016,N,N
15,1,0,14,ACC,Atlantic,Clemson,2016,Y,N
14,4,0,10,Pac-12,South,Colorado,2016,N,N
13,6,0,7,Mountain West,Mountain,Colorado State,2016,N,N
12,9,0,3,American Athletic,East,Connecticut,2016,N,N
12,8,0,4,ACC,Coastal,Duke,2016,N,N
12,9,0,3,American Athletic,East,East Carolina,2016,N,N
13,6,0,7,Mid-American,West,Eastern Michigan,2016,N,N
13,4,0,9,SEC,East,Florida,2016,N,N
12,9,0,3,Conference USA,East,Florida Atlantic,2016,N,N
12,8,0,4,Conference USA,East,Florida International,2016,N,N
13,3,0,10,ACC,Atlantic,Florida State,2016,N,N
12,11,0,1,Mountain West,West,Fresno State,2016,N,N
13,5,0,8,SEC,East,Georgia,2016,N,N
12,7,0,5,Sun Belt,West,Georgia Southern,2016,N,N
12,9,0,3,Sun Belt,West,Georgia State,2016,N,N
13,4,0,9,ACC,Coastal,Georgia Tech,2016,N,N
14,7,0,7,Mountain West,West,Hawai'i,2016,N,N
13,4,0,9,American Athletic,West,Houston,2016,N,N
13,4,0,9,Sun Belt,,Idaho,2016,N,N
12,9,0,3,Big Ten,West,Illinois,2016,N,N
13,7,0,6,Big Ten,East,Indiana,2016,N,N
13,5,0,8,Big Ten,West,Iowa,2016,N,N
12,9,0,3,Big 12,,Iowa State,2016,N,N
12,10,0,2,Big 12,,Kansas,2016,N,N
13,4,0,9,Big 12,,Kansas State,2016,N,N
12,9,0,3,Mid-American,East,Kent State,2016,N,N
13,6,0,7,SEC,East,Kentucky,2016,N,N
13,7,0,6,Sun Belt,East,Louisiana,2016,N,N
12,8,0,4,Sun Belt,East,Louisiana Monroe,2016,N,N
14,5,0,9,Conference USA,West,Louisiana Tech,2016,N,N
13,4,0,9,ACC,Atlantic,Louisville,2016,N,N
12,4,0,8,SEC,West,LSU,2016,N,N
12,9,0,3,Conference USA,East,Marshall,2016,N,N
13,7,0,6,Big Ten,East,Maryland,2016,N,N
13,5,0,8,American Athletic,West,Memphis,2016,N,N
13,4,0,9,ACC,Coastal,Miami,2016,N,N
13,7,0,6,Mid-American,East,Miami (OH),2016,N,N
13,3,0,10,Big Ten,East,Michigan,2016,N,N
12,9,0,3,Big Ten,East,Michigan State,2016,N,N
13,5,0,8,Conference USA,East,Middle Tennessee,2016,N,N
13,4,0,9,Big Ten,West,Minnesota,2016,N,N
13,7,0,6,SEC,West,Mississippi State,2016,N,N
12,8,0,4,SEC,East,Missouri,2016,N,N
14,5,0,9,American Athletic,West,Navy,2016,N,N
13,6,0,7,ACC,Atlantic,NC State,2016,N,N
13,4,0,9,Big Ten,West,Nebraska,2016,N,N
12,7,0,5,Mountain West,West,Nevada,2016,N,N
13,4,0,9,Mountain West,Mountain,New Mexico,2016,N,N
12,9,0,3,Sun Belt,,New Mexico State,2016,N,N
13,5,0,8,ACC,Coastal,North Carolina,2016,N,N
12,7,0,5,Mid-American,West,Northern Illinois,2016,N,N
13,8,0,5,Conference USA,West,North Texas,2016,N,N
13,6,0,7,Big Ten,West,Northwestern,2016,N,N
12,8,0,4,FBS Independents,,Notre Dame,2016,N,N
14,6,0,8,Mid-American,East,Ohio,2016,N,N
13,2,0,11,Big Ten,East,Ohio State,2016,N,N
13,2,0,11,Big 12,,Oklahoma,2016,N,N
13,3,0,10,Big 12,,Oklahoma State,2016,N,N
13,3,0,10,Conference USA,East,Old Dominion,2016,N,N
12,7,0,5,SEC,West,Ole Miss,2016,N,N
12,8,0,4,Pac-12,North,Oregon,2016,N,N
12,8,0,4,Pac-12,North,Oregon State,2016,N,N
14,3,0,11,Big Ten,East,Penn State,2016,N,N
13,5,0,8,ACC,Coastal,Pittsburgh,2016,N,N
12,9,0,3,Big Ten,West,Purdue,2016,N,N
12,9,0,3,Conference USA,West,Rice,2016,N,N
12,10,0,2,Big Ten,East,Rutgers,2016,N,N
14,3,0,11,Mountain West,West,San Diego State,2016,N,N
12,8,0,4,Mountain West,West,San Josï¿½ State,2016,N,N
12,7,0,5,American Athletic,West,SMU,2016,N,N
13,7,0,6,Sun Belt,East,South Alabama,2016,N,N
13,7,0,6,SEC,East,South Carolina,2016,N,N
13,6,0,7,Conference USA,West,Southern Mississippi,2016,N,N
13,2,0,11,American Athletic,East,South Florida,2016,N,N
13,3,0,10,Pac-12,North,Stanford,2016,N,N
12,8,0,4,ACC,Atlantic,Syracuse,2016,N,N
13,7,0,6,Big 12,,TCU,2016,N,N
14,4,0,10,American Athletic,East,Temple,2016,N,N
13,4,0,9,SEC,East,Tennessee,2016,N,N
12,7,0,5,Big 12,,Texas,2016,N,N
13,5,0,8,SEC,West,Texas A&M,2016,N,N
12,10,0,2,Sun Belt,East,Texas State,2016,N,N
12,7,0,5,Big 12,,Texas Tech,2016,N,N
13,4,0,9,Mid-American,West,Toledo,2016,N,N
13,3,0,10,Sun Belt,East,Troy,2016,N,N
12,8,0,4,American Athletic,West,Tulane,2016,N,N
13,3,0,10,American Athletic,West,Tulsa,2016,N,N
13,7,0,6,American Athletic,East,UCF,2016,N,N
12,8,0,4,Pac-12,South,UCLA,2016,N,N
12,10,0,2,FBS Independents,,UMass,2016,N,N
12,8,0,4,Mountain West,West,UNLV,2016,N,N
13,3,0,10,Pac-12,South,USC,2016,N,N
13,4,0,9,Pac-12,South,Utah,2016,N,N
12,9,0,3,Mountain West,Mountain,Utah State,2016,N,N
12,8,0,4,Conference USA,West,UTEP,2016,N,N
13,7,0,6,Conference USA,West,UT San Antonio,2016,N,N
13,7,0,6,SEC,East,Vanderbilt,2016,N,N
12,10,0,2,ACC,Coastal,Virginia,2016,N,N
14,4,0,10,ACC,Coastal,Virginia Tech,2016,N,N
13,6,0,7,ACC,Atlantic,Wake Forest,2016,N,N
14,2,0,12,Pac-12,North,Washington,2016,N,N
13,5,0,8,Pac-12,North,Washington State,2016,N,N
14,3,0,11,Conference USA,East,Western Kentucky,2016,N,N
14,1,0,13,Mid-American,West,Western Michigan,2016,N,N
13,3,0,10,Big 12,,West Virginia,2016,N,N
14,3,0,11,Big Ten,West,Wisconsin,2016,N,N
14,6,0,8,Mountain West,Mountain,Wyoming,2016,N,N
12,7,0,5,Mountain West,Mountain,Air Force,2017,N,N
14,7,0,7,Mid-American,East,Akron,2017,N,N
14,1,0,13,SEC,West,Alabama,2017,Y,N
13,4,0,9,Sun Belt,West,Appalachian State,2017,N,N
13,6,0,7,Pac-12,South,Arizona,2017,N,N
13,6,0,7,Pac-12,South,Arizona State,2017,N,N
12,8,0,4,SEC,West,Arkansas,2017,N,N
12,5,0,7,Sun Belt,East,Arkansas State,2017,N,N
13,3,0,10,FBS Independents,,Army,2017,N,N
14,4,0,10,SEC,West,Auburn,2017,N,N
12,10,0,2,Mid-American,West,Ball State,2017,N,N
12,11,0,1,Big 12,,Baylor,2017,N,N
14,3,0,11,Mountain West,Mountain,Boise State,2017,N,N
13,6,0,7,ACC,Atlantic,Boston College,2017,N,N
12,10,0,2,Mid-American,East,Bowling Green,2017,N,N
12,6,0,6,Mid-American,East,Buffalo,2017,N,N
13,9,0,4,FBS Independents,,BYU,2017,N,N
12,7,0,5,Pac-12,North,California,2017,N,N
13,5,0,8,Mid-American,West,Central Michigan,2017,N,N
12,11,0,1,Conference USA,East,Charlotte,2017,N,N
12,8,0,4,American Athletic,East,Cincinnati,2017,N,N
14,2,0,12,ACC,Atlantic,Clemson,2017,N,N
12,9,0,3,Sun Belt,West,Coastal Carolina,2017,N,N
12,7,0,5,Pac-12,South,Colorado,2017,N,N
13,6,0,7,Mountain West,Mountain,Colorado State,2017,N,N
12,9,0,3,American Athletic,East,Connecticut,2017,N,N
13,6,0,7,ACC,Coastal,Duke,2017,N,N
12,9,0,3,American Athletic,East,East Carolina,2017,N,N
12,7,0,5,Mid-American,West,Eastern Michigan,2017,N,N
11,7,0,4,SEC,East,Florida,2017,N,N
14,3,0,11,Conference USA,East,Florida Atlantic,2017,N,N
13,5,0,8,Conference USA,East,Florida International,2017,N,N
13,6,0,7,ACC,Atlantic,Florida State,2017,N,N
14,4,0,10,Mountain West,West,Fresno State,2017,N,N
15,2,0,13,SEC,East,Georgia,2017,N,Y
12,10,0,2,Sun Belt,West,Georgia Southern,2017,N,N
12,5,0,7,Sun Belt,West,Georgia State,2017,N,N
11,6,0,5,ACC,Coastal,Georgia Tech,2017,N,N
12,9,0,3,Mountain West,West,Hawai'i,2017,N,N
12,5,0,7,American Athletic,West,Houston,2017,N,N
12,8,0,4,Sun Belt,,Idaho,2017,N,N
12,10,0,2,Big Ten,West,Illinois,2017,N,N
12,7,0,5,Big Ten,East,Indiana,2017,N,N
13,5,0,8,Big Ten,West,Iowa,2017,N,N
13,5,0,8,Big 12,,Iowa State,2017,N,N
12,11,0,1,Big 12,,Kansas,2017,N,N
13,5,0,8,Big 12,,Kansas State,2017,N,N
12,10,0,2,Mid-American,East,Kent State,2017,N,N
13,6,0,7,SEC,East,Kentucky,2017,N,N
12,7,0,5,Sun Belt,East,Louisiana,2017,N,N
12,8,0,4,Sun Belt,East,Louisiana Monroe,2017,N,N
13,6,0,7,Conference USA,West,Louisiana Tech,2017,N,N
13,5,0,8,ACC,Atlantic,Louisville,2017,N,N
13,4,0,9,SEC,West,LSU,2017,N,N
13,5,0,8,Conference USA,East,Marshall,2017,N,N
12,8,0,4,Big Ten,East,Maryland,2017,N,N
13,3,0,10,American Athletic,West,Memphis,2017,N,N
13,3,0,10,ACC,Coastal,Miami,2017,N,N
12,7,0,5,Mid-American,East,Miami (OH),2017,N,N
13,5,0,8,Big Ten,East,Michigan,2017,N,N
13,3,0,10,Big Ten,East,Michigan State,2017,N,N
13,6,0,7,Conference USA,East,Middle Tennessee,2017,N,N
12,7,0,5,Big Ten,West,Minnesota,2017,N,N
13,4,0,9,SEC,West,Mississippi State,2017,N,N
13,6,0,7,SEC,East,Missouri,2017,N,N
13,6,0,7,American Athletic,West,Navy,2017,N,N
13,4,0,9,ACC,Atlantic,NC State,2017,N,N
12,8,0,4,Big Ten,West,Nebraska,2017,N,N
12,9,0,3,Mountain West,West,Nevada,2017,N,N
12,9,0,3,Mountain West,Mountain,New Mexico,2017,N,N
13,6,0,7,Sun Belt,,New Mexico State,2017,N,N
12,9,0,3,ACC,Coastal,North Carolina,2017,N,N
13,5,0,8,Mid-American,West,Northern Illinois,2017,N,N
14,5,0,9,Conference USA,West,North Texas,2017,N,N
13,3,0,10,Big Ten,West,Northwestern,2017,N,N
13,3,0,10,FBS Independents,,Notre Dame,2017,N,N
13,4,0,9,Mid-American,East,Ohio,2017,N,N
14,2,0,12,Big Ten,East,Ohio State,2017,N,N
14,2,0,12,Big 12,,Oklahoma,2017,N,N
13,3,0,10,Big 12,,Oklahoma State,2017,N,N
12,7,0,5,Conference USA,East,Old Dominion,2017,N,N
12,6,0,6,SEC,West,Ole Miss,2017,N,N
13,6,0,7,Pac-12,North,Oregon,2017,N,N
12,11,0,1,Pac-12,North,Oregon State,2017,N,N
13,2,0,11,Big Ten,East,Penn State,2017,N,N
12,7,0,5,ACC,Coastal,Pittsburgh,2017,N,N
13,6,0,7,Big Ten,West,Purdue,2017,N,N
12,11,0,1,Conference USA,West,Rice,2017,N,N
12,8,0,4,Big Ten,East,Rutgers,2017,N,N
13,3,0,10,Mountain West,West,San Diego State,2017,N,N
13,11,0,2,Mountain West,West,San Josï¿½ State,2017,N,N
13,6,0,7,American Athletic,West,SMU,2017,N,N
12,8,0,4,Sun Belt,East,South Alabama,2017,N,N
13,4,0,9,SEC,East,South Carolina,2017,N,N
13,5,0,8,Conference USA,West,Southern Mississippi,2017,N,N
12,2,0,10,American Athletic,East,South Florida,2017,N,N
14,5,0,9,Pac-12,North,Stanford,2017,N,N
12,8,0,4,ACC,Atlantic,Syracuse,2017,N,N
14,3,0,11,Big 12,,TCU,2017,N,N
13,6,0,7,American Athletic,East,Temple,2017,N,N
12,8,0,4,SEC,East,Tennessee,2017,N,N
13,6,0,7,Big 12,,Texas,2017,N,N
13,6,0,7,SEC,West,Texas A&M,2017,N,N
12,10,0,2,Sun Belt,East,Texas State,2017,N,N
13,7,0,6,Big 12,,Texas Tech,2017,N,N
14,3,0,11,Mid-American,West,Toledo,2017,N,N
13,2,0,11,Sun Belt,East,Troy,2017,N,N
12,7,0,5,American Athletic,West,Tulane,2017,N,N
12,10,0,2,American Athletic,West,Tulsa,2017,N,N
13,5,0,8,Conference USA,West,UAB,2017,N,N
13,0,0,13,American Athletic,East,UCF,2017,N,N
13,7,0,6,Pac-12,South,UCLA,2017,N,N
12,8,0,4,FBS Independents,,UMass,2017,N,N
12,7,0,5,Mountain West,West,UNLV,2017,N,N
14,3,0,11,Pac-12,South,USC,2017,N,N
13,6,0,7,Pac-12,South,Utah,2017,N,N
13,7,0,6,Mountain West,Mountain,Utah State,2017,N,N
12,12,0,0,Conference USA,West,UTEP,2017,N,N
11,5,0,6,Conference USA,West,UT San Antonio,2017,N,N
12,7,0,5,SEC,East,Vanderbilt,2017,N,N
13,7,0,6,ACC,Coastal,Virginia,2017,N,N
13,4,0,9,ACC,Coastal,Virginia Tech,2017,N,N
13,5,0,8,ACC,Atlantic,Wake Forest,2017,N,N
13,3,0,10,Pac-12,North,Washington,2017,N,N
13,4,0,9,Pac-12,North,Washington State,2017,N,N
13,7,0,6,Conference USA,East,Western Kentucky,2017,N,N
12,6,0,6,Mid-American,West,Western Michigan,2017,N,N
13,6,0,7,Big 12,,West Virginia,2017,N,N
14,1,0,13,Big Ten,West,Wisconsin,2017,N,N
13,5,0,8,Mountain West,Mountain,Wyoming,2017,N,N
12,7,0,5,Mountain West,Mountain,Air Force,2018,N,N
12,8,0,4,Mid-American,East,Akron,2018,N,N
15,1,0,14,SEC,West,Alabama,2018,N,Y
13,2,0,11,Sun Belt,West,Appalachian State,2018,N,N
12,7,0,5,Pac-12,South,Arizona,2018,N,N
13,6,0,7,Pac-12,South,Arizona State,2018,N,N
12,10,0,2,SEC,West,Arkansas,2018,N,N
13,5,0,8,Sun Belt,East,Arkansas State,2018,N,N
13,2,0,11,FBS Independents,,Army,2018,N,N
13,5,0,8,SEC,West,Auburn,2018,N,N
12,8,0,4,Mid-American,West,Ball State,2018,N,N
13,6,0,7,Big 12,,Baylor,2018,N,N
13,3,0,10,Mountain West,Mountain,Boise State,2018,N,N
12,5,0,7,ACC,Atlantic,Boston College,2018,N,N
12,9,0,3,Mid-American,East,Bowling Green,2018,N,N
14,4,0,10,Mid-American,East,Buffalo,2018,N,N
13,6,0,7,FBS Independents,,BYU,2018,N,N
13,6,0,7,Pac-12,North,California,2018,N,N
12,11,0,1,Mid-American,West,Central Michigan,2018,N,N
12,7,0,5,Conference USA,East,Charlotte,2018,N,N
13,2,0,11,American Athletic,East,Cincinnati,2018,N,N
15,0,0,15,ACC,Atlantic,Clemson,2018,Y,N
12,7,0,5,Sun Belt,West,Coastal Carolina,2018,N,N
12,7,0,5,Pac-12,South,Colorado,2018,N,N
12,9,0,3,Mountain West,Mountain,Colorado State,2018,N,N
12,11,0,1,American Athletic,East,Connecticut,2018,N,N
13,5,0,8,ACC,Coastal,Duke,2018,N,N
12,9,0,3,American Athletic,East,East Carolina,2018,N,N
13,6,0,7,Mid-American,West,Eastern Michigan,2018,N,N
13,3,0,10,SEC,East,Florida,2018,N,N
12,7,0,5,Conference USA,East,Florida Atlantic,2018,N,N
13,4,0,9,Conference USA,East,Florida International,2018,N,N
12,7,0,5,ACC,Atlantic,Florida State,2018,N,N
14,2,0,12,Mountain West,West,Fresno State,2018,N,N
14,3,0,11,SEC,East,Georgia,2018,N,N
13,3,0,10,Sun Belt,West,Georgia Southern,2018,N,N
12,10,0,2,Sun Belt,West,Georgia State,2018,N,N
13,6,0,7,ACC,Coastal,Georgia Tech,2018,N,N
14,6,0,8,Mountain West,West,Hawai'i,2018,N,N
13,5,0,8,American Athletic,West,Houston,2018,N,N
12,8,0,4,Big Ten,West,Illinois,2018,N,N
12,7,0,5,Big Ten,East,Indiana,2018,N,N
13,4,0,9,Big Ten,West,Iowa,2018,N,N
13,5,0,8,Big 12,,Iowa State,2018,N,N
12,9,0,3,Big 12,,Kansas,2018,N,N
12,7,0,5,Big 12,,Kansas State,2018,N,N
12,10,0,2,Mid-American,East,Kent State,2018,N,N
13,4,0,9,SEC,East,Kentucky,2018,N,N
12,6,0,6,FBS Independents,,Liberty,2018,N,N
14,7,0,7,Sun Belt,East,Louisiana,2018,N,N
12,6,0,6,Sun Belt,East,Louisiana Monroe,2018,N,N
13,5,0,8,Conference USA,West,Louisiana Tech,2018,N,N
12,10,0,2,ACC,Atlantic,Louisville,2018,N,N
13,3,0,10,SEC,West,LSU,2018,N,N
13,4,0,9,Conference USA,East,Marshall,2018,N,N
12,7,0,5,Big Ten,East,Maryland,2018,N,N
14,6,0,8,American Athletic,West,Memphis,2018,N,N
13,6,0,7,ACC,Coastal,Miami,2018,N,N
12,6,0,6,Mid-American,East,Miami (OH),2018,N,N
13,3,0,10,Big Ten,East,Michigan,2018,N,N
13,6,0,7,Big Ten,East,Michigan State,2018,N,N
14,6,0,8,Conference USA,East,Middle Tennessee,2018,N,N
13,6,0,7,Big Ten,West,Minnesota,2018,N,N
13,5,0,8,SEC,West,Mississippi State,2018,N,N
13,4,0,9,SEC,East,Missouri,2018,N,N
13,10,0,3,American Athletic,West,Navy,2018,N,N
13,4,0,9,ACC,Atlantic,NC State,2018,N,N
12,8,0,4,Big Ten,West,Nebraska,2018,N,N
13,5,0,8,Mountain West,West,Nevada,2018,N,N
12,9,0,3,Mountain West,Mountain,New Mexico,2018,N,N
12,9,0,3,FBS Independents,,New Mexico State,2018,N,N
11,9,0,2,ACC,Coastal,North Carolina,2018,N,N
14,6,0,8,Mid-American,West,Northern Illinois,2018,N,N
13,4,0,9,Conference USA,West,North Texas,2018,N,N
14,5,0,9,Big Ten,West,Northwestern,2018,N,N
13,1,0,12,FBS Independents,,Notre Dame,2018,N,N
13,4,0,9,Mid-American,East,Ohio,2018,N,N
14,1,0,13,Big Ten,East,Ohio State,2018,N,N
14,2,0,12,Big 12,,Oklahoma,2018,N,N
13,6,0,7,Big 12,,Oklahoma State,2018,N,N
12,8,0,4,Conference USA,East,Old Dominion,2018,N,N
12,7,0,5,SEC,West,Ole Miss,2018,N,N
13,4,0,9,Pac-12,North,Oregon,2018,N,N
12,10,0,2,Pac-12,North,Oregon State,2018,N,N
13,4,0,9,Big Ten,East,Penn State,2018,N,N
14,7,0,7,ACC,Coastal,Pittsburgh,2018,N,N
13,7,0,6,Big Ten,West,Purdue,2018,N,N
13,11,0,2,Conference USA,West,Rice,2018,N,N
12,11,0,1,Big Ten,East,Rutgers,2018,N,N
13,6,0,7,Mountain West,West,San Diego State,2018,N,N
12,11,0,1,Mountain West,West,San Josï¿½ State,2018,N,N
12,7,0,5,American Athletic,West,SMU,2018,N,N
12,9,0,3,Sun Belt,East,South Alabama,2018,N,N
13,6,0,7,SEC,East,South Carolina,2018,N,N
11,5,0,6,Conference USA,West,Southern Mississippi,2018,N,N
13,6,0,7,American Athletic,East,South Florida,2018,N,N
13,4,0,9,Pac-12,North,Stanford,2018,N,N
13,3,0,10,ACC,Atlantic,Syracuse,2018,N,N
13,6,0,7,Big 12,,TCU,2018,N,N
13,5,0,8,American Athletic,East,Temple,2018,N,N
12,7,0,5,SEC,East,Tennessee,2018,N,N
14,4,0,10,Big 12,,Texas,2018,N,N
13,4,0,9,SEC,West,Texas A&M,2018,N,N
12,9,0,3,Sun Belt,East,Texas State,2018,N,N
12,7,0,5,Big 12,,Texas Tech,2018,N,N
13,6,0,7,Mid-American,West,Toledo,2018,N,N
13,3,0,10,Sun Belt,East,Troy,2018,N,N
13,6,0,7,American Athletic,West,Tulane,2018,N,N
12,9,0,3,American Athletic,West,Tulsa,2018,N,N
14,3,0,11,Conference USA,West,UAB,2018,N,N
13,1,0,12,American Athletic,East,UCF,2018,N,N
12,9,0,3,Pac-12,South,UCLA,2018,N,N
12,8,0,4,FBS Independents,,UMass,2018,N,N
12,8,0,4,Mountain West,West,UNLV,2018,N,N
12,7,0,5,Pac-12,South,USC,2018,N,N
14,5,0,9,Pac-12,South,Utah,2018,N,N
13,2,0,11,Mountain West,Mountain,Utah State,2018,N,N
12,11,0,1,Conference USA,West,UTEP,2018,N,N
12,9,0,3,Conference USA,West,UT San Antonio,2018,N,N
13,7,0,6,SEC,East,Vanderbilt,2018,N,N
13,5,0,8,ACC,Coastal,Virginia,2018,N,N
13,7,0,6,ACC,Coastal,Virginia Tech,2018,N,N
13,6,0,7,ACC,Atlantic,Wake Forest,2018,N,N
14,4,0,10,Pac-12,North,Washington,2018,N,N
13,2,0,11,Pac-12,North,Washington State,2018,N,N
12,9,0,3,Conference USA,East,Western Kentucky,2018,N,N
13,6,0,7,Mid-American,West,Western Michigan,2018,N,N
12,4,0,8,Big 12,,West Virginia,2018,N,N
13,5,0,8,Big Ten,West,Wisconsin,2018,N,N
12,6,0,6,Mountain West,Mountain,Wyoming,2018,N,N
13,2,0,11,Mountain West,Mountain,Air Force,2019,N,N
12,12,0,0,Mid-American,East,Akron,2019,N,N
13,2,0,11,SEC,West,Alabama,2019,N,N
14,1,0,13,Sun Belt,West,Appalachian State,2019,N,N
12,8,0,4,Pac-12,South,Arizona,2019,N,N
13,5,0,8,Pac-12,South,Arizona State,2019,N,N
12,10,0,2,SEC,West,Arkansas,2019,N,N
13,5,0,8,Sun Belt,East,Arkansas State,2019,N,N
13,8,0,5,FBS Independents,,Army,2019,N,N
13,4,0,9,SEC,West,Auburn,2019,N,N
12,7,0,5,Mid-American,West,Ball State,2019,N,N
14,3,0,11,Big 12,,Baylor,2019,N,N
14,2,0,12,Mountain West,Mountain,Boise State,2019,N,N
13,7,0,6,ACC,Atlantic,Boston College,2019,N,N
12,9,0,3,Mid-American,East,Bowling Green,2019,N,N
13,5,0,8,Mid-American,East,Buffalo,2019,N,N
13,6,0,7,FBS Independents,,BYU,2019,N,N
13,5,0,8,Pac-12,North,California,2019,N,N
14,6,0,8,Mid-American,West,Central Michigan,2019,N,N
13,6,0,7,Conference USA,East,Charlotte,2019,N,N
14,3,0,11,American Athletic,East,Cincinnati,2019,N,N
15,1,0,14,ACC,Atlantic,Clemson,2019,N,Y
12,7,0,5,Sun Belt,West,Coastal Carolina,2019,N,N
12,7,0,5,Pac-12,South,Colorado,2019,N,N
12,8,0,4,Mountain West,Mountain,Colorado State,2019,N,N
12,10,0,2,American Athletic,East,Connecticut,2019,N,N
12,7,0,5,ACC,Coastal,Duke,2019,N,N
12,8,0,4,American Athletic,East,East Carolina,2019,N,N
13,7,0,6,Mid-American,West,Eastern Michigan,2019,N,N
13,2,0,11,SEC,East,Florida,2019,N,N
14,3,0,11,Conference USA,East,Florida Atlantic,2019,N,N
13,7,0,6,Conference USA,East,Florida International,2019,N,N
13,7,0,6,ACC,Atlantic,Florida State,2019,N,N
12,8,0,4,Mountain West,West,Fresno State,2019,N,N
14,2,0,12,SEC,East,Georgia,2019,N,N
13,6,0,7,Sun Belt,West,Georgia Southern,2019,N,N
13,6,0,7,Sun Belt,West,Georgia State,2019,N,N
12,9,0,3,ACC,Coastal,Georgia Tech,2019,N,N
15,5,0,10,Mountain West,West,Hawai'i,2019,N,N
12,8,0,4,American Athletic,West,Houston,2019,N,N
13,7,0,6,Big Ten,West,Illinois,2019,N,N
13,5,0,8,Big Ten,East,Indiana,2019,N,N
13,3,0,10,Big Ten,West,Iowa,2019,N,N
13,6,0,7,Big 12,,Iowa State,2019,N,N
12,9,0,3,Big 12,,Kansas,2019,N,N
13,5,0,8,Big 12,,Kansas State,2019,N,N
13,6,0,7,Mid-American,East,Kent State,2019,N,N
13,5,0,8,SEC,East,Kentucky,2019,N,N
13,5,0,8,FBS Independents,,Liberty,2019,N,N
14,3,0,11,Sun Belt,East,Louisiana,2019,N,N
12,7,0,5,Sun Belt,East,Louisiana Monroe,2019,N,N
13,3,0,10,Conference USA,West,Louisiana Tech,2019,N,N
13,5,0,8,ACC,Atlantic,Louisville,2019,N,N
15,0,0,15,SEC,West,LSU,2019,Y,N
13,5,0,8,Conference USA,East,Marshall,2019,N,N
12,9,0,3,Big Ten,East,Maryland,2019,N,N
14,2,0,12,American Athletic,West,Memphis,2019,N,N
13,7,0,6,ACC,Coastal,Miami,2019,N,N
14,6,0,8,Mid-American,East,Miami (OH),2019,N,N
13,4,0,9,Big Ten,East,Michigan,2019,N,N
13,6,0,7,Big Ten,East,Michigan State,2019,N,N
12,8,0,4,Conference USA,East,Middle Tennessee,2019,N,N
13,2,0,11,Big Ten,West,Minnesota,2019,N,N
13,7,0,6,SEC,West,Mississippi State,2019,N,N
12,6,0,6,SEC,East,Missouri,2019,N,N
13,2,0,11,American Athletic,West,Navy,2019,N,N
12,8,0,4,ACC,Atlantic,NC State,2019,N,N
12,7,0,5,Big Ten,West,Nebraska,2019,N,N
13,6,0,7,Mountain West,West,Nevada,2019,N,N
12,10,0,2,Mountain West,Mountain,New Mexico,2019,N,N
12,10,0,2,FBS Independents,,New Mexico State,2019,N,N
13,6,0,7,ACC,Coastal,North Carolina,2019,N,N
12,7,0,5,Mid-American,West,Northern Illinois,2019,N,N
12,8,0,4,Conference USA,West,North Texas,2019,N,N
12,9,0,3,Big Ten,West,Northwestern,2019,N,N
13,2,0,11,FBS Independents,,Notre Dame,2019,N,N
13,6,0,7,Mid-American,East,Ohio,2019,N,N
14,1,0,13,Big Ten,East,Ohio State,2019,N,N
14,2,0,12,Big 12,,Oklahoma,2019,N,N
13,5,0,8,Big 12,,Oklahoma State,2019,N,N
12,11,0,1,Conference USA,East,Old Dominion,2019,N,N
12,8,0,4,SEC,West,Ole Miss,2019,N,N
14,2,0,12,Pac-12,North,Oregon,2019,N,N
12,7,0,5,Pac-12,North,Oregon State,2019,N,N
13,2,0,11,Big Ten,East,Penn State,2019,N,N
13,5,0,8,ACC,Coastal,Pittsburgh,2019,N,N
12,8,0,4,Big Ten,West,Purdue,2019,N,N
12,9,0,3,Conference USA,West,Rice,2019,N,N
12,10,0,2,Big Ten,East,Rutgers,2019,N,N
13,3,0,10,Mountain West,West,San Diego State,2019,N,N
12,7,0,5,Mountain West,West,San Josï¿½ State,2019,N,N
13,3,0,10,American Athletic,West,SMU,2019,N,N
12,10,0,2,Sun Belt,East,South Alabama,2019,N,N
12,8,0,4,SEC,East,South Carolina,2019,N,N
13,6,0,7,Conference USA,West,Southern Mississippi,2019,N,N
12,8,0,4,American Athletic,East,South Florida,2019,N,N
12,8,0,4,Pac-12,North,Stanford,2019,N,N
12,7,0,5,ACC,Atlantic,Syracuse,2019,N,N
12,7,0,5,Big 12,,TCU,2019,N,N
13,5,0,8,American Athletic,East,Temple,2019,N,N
13,5,0,8,SEC,East,Tennessee,2019,N,N
13,5,0,8,Big 12,,Texas,2019,N,N
13,5,0,8,SEC,West,Texas A&M,2019,N,N
12,9,0,3,Sun Belt,East,Texas State,2019,N,N
12,8,0,4,Big 12,,Texas Tech,2019,N,N
12,6,0,6,Mid-American,West,Toledo,2019,N,N
12,7,0,5,Sun Belt,East,Troy,2019,N,N
13,6,0,7,American Athletic,West,Tulane,2019,N,N
12,8,0,4,American Athletic,West,Tulsa,2019,N,N
14,5,0,9,Conference USA,West,UAB,2019,N,N
13,3,0,10,American Athletic,East,UCF,2019,N,N
12,8,0,4,Pac-12,South,UCLA,2019,N,N
12,11,0,1,FBS Independents,,UMass,2019,N,N
12,8,0,4,Mountain West,West,UNLV,2019,N,N
13,5,0,8,Pac-12,South,USC,2019,N,N
14,3,0,11,Pac-12,South,Utah,2019,N,N
13,6,0,7,Mountain West,Mountain,Utah State,2019,N,N
12,11,0,1,Conference USA,West,UTEP,2019,N,N
12,8,0,4,Conference USA,West,UT San Antonio,2019,N,N
12,9,0,3,SEC,East,Vanderbilt,2019,N,N
14,5,0,9,ACC,Coastal,Virginia,2019,N,N
13,5,0,8,ACC,Coastal,Virginia Tech,2019,N,N
13,5,0,8,ACC,Atlantic,Wake Forest,2019,N,N
13,5,0,8,Pac-12,North,Washington,2019,N,N
13,7,0,6,Pac-12,North,Washington State,2019,N,N
13,4,0,9,Conference USA,East,Western Kentucky,2019,N,N
13,6,0,7,Mid-American,West,Western Michigan,2019,N,N
12,7,0,5,Big 12,,West Virginia,2019,N,N
14,4,0,10,Big Ten,West,Wisconsin,2019,N,N
13,5,0,8,Mountain West,Mountain,Wyoming,2019,N,N
6,3,0,3,Mountain West,Mountain,Air Force,2020,N,N
6,5,0,1,Mid-American,East,Akron,2020,N,N
13,0,0,13,SEC,West,Alabama,2020,Y,N
12,3,0,9,Sun Belt,West,Appalachian State,2020,N,N
5,5,0,0,Pac-12,South,Arizona,2020,N,N
4,2,0,2,Pac-12,South,Arizona State,2020,N,N
10,7,0,3,SEC,West,Arkansas,2020,N,N
11,7,0,4,Sun Belt,East,Arkansas State,2020,N,N
12,3,0,9,FBS Independents,,Army,2020,N,N
11,5,0,6,SEC,West,Auburn,2020,N,N
8,1,0,7,Mid-American,West,Ball State,2020,N,N
9,7,0,2,Big 12,,Baylor,2020,N,N
7,2,0,5,Mountain West,Mountain,Boise State,2020,N,N
11,5,0,6,ACC,Atlantic,Boston College,2020,N,N
5,5,0,0,Mid-American,East,Bowling Green,2020,N,N
7,1,0,6,Mid-American,East,Buffalo,2020,N,N
12,1,0,11,FBS Independents,,BYU,2020,N,N
4,3,0,1,Pac-12,North,California,2020,N,N
6,3,0,3,Mid-American,West,Central Michigan,2020,N,N
6,4,0,2,Conference USA,East,Charlotte,2020,N,N
10,1,0,9,American Athletic,East,Cincinnati,2020,N,N
12,2,0,10,ACC,Atlantic,Clemson,2020,N,N
12,1,0,11,Sun Belt,West,Coastal Carolina,2020,N,N
6,2,0,4,Pac-12,South,Colorado,2020,N,N
4,3,0,1,Mountain West,Mountain,Colorado State,2020,N,N
11,9,0,2,ACC,Coastal,Duke,2020,N,N
9,6,0,3,American Athletic,East,East Carolina,2020,N,N
6,4,0,2,Mid-American,West,Eastern Michigan,2020,N,N
12,4,0,8,SEC,East,Florida,2020,N,N
9,4,0,5,Conference USA,East,Florida Atlantic,2020,N,N
5,5,0,0,Conference USA,East,Florida International,2020,N,N
9,6,0,3,ACC,Atlantic,Florida State,2020,N,N
6,3,0,3,Mountain West,West,Fresno State,2020,N,N
10,2,0,8,SEC,East,Georgia,2020,N,N
13,5,0,8,Sun Belt,West,Georgia Southern,2020,N,N
10,4,0,6,Sun Belt,West,Georgia State,2020,N,N
10,7,0,3,ACC,Coastal,Georgia Tech,2020,N,N
9,4,0,5,Mountain West,West,Hawai'i,2020,N,N
8,5,0,3,American Athletic,West,Houston,2020,N,N
8,6,0,2,Big Ten,West,Illinois,2020,N,N
8,2,0,6,Big Ten,East,Indiana,2020,N,N
8,2,0,6,Big Ten,West,Iowa,2020,N,N
12,3,0,9,Big 12,,Iowa State,2020,N,N
9,9,0,0,Big 12,,Kansas,2020,N,N
10,6,0,4,Big 12,,Kansas State,2020,N,N
4,1,0,3,Mid-American,East,Kent State,2020,N,N
11,6,0,5,SEC,East,Kentucky,2020,N,N
11,1,0,10,FBS Independents,,Liberty,2020,N,N
11,1,0,10,Sun Belt,East,Louisiana,2020,N,N
10,10,0,0,Sun Belt,East,Louisiana Monroe,2020,N,N
10,5,0,5,Conference USA,West,Louisiana Tech,2020,N,N
11,7,0,4,ACC,Atlantic,Louisville,2020,N,N
10,5,0,5,SEC,West,LSU,2020,N,N
10,3,0,7,Conference USA,East,Marshall,2020,N,N
5,3,0,2,Big Ten,East,Maryland,2020,N,N
11,3,0,8,American Athletic,West,Memphis,2020,N,N
11,3,0,8,ACC,Coastal,Miami,2020,N,N
3,1,0,2,Mid-American,East,Miami (OH),2020,N,N
6,4,0,2,Big Ten,East,Michigan,2020,N,N
7,5,0,2,Big Ten,East,Michigan State,2020,N,N
9,6,0,3,Conference USA,East,Middle Tennessee,2020,N,N
7,4,0,3,Big Ten,West,Minnesota,2020,N,N
11,7,0,4,SEC,West,Mississippi State,2020,N,N
10,5,0,5,SEC,East,Missouri,2020,N,N
10,7,0,3,American Athletic,West,Navy,2020,N,N
12,4,0,8,ACC,Atlantic,NC State,2020,N,N
8,5,0,3,Big Ten,West,Nebraska,2020,N,N
9,2,0,7,Mountain West,West,Nevada,2020,N,N
7,5,0,2,Mountain West,Mountain,New Mexico,2020,N,N
2,1,0,1,FBS Independents,,New Mexico State,2020,N,N
12,4,0,8,ACC,Coastal,North Carolina,2020,N,N
6,6,0,0,Mid-American,West,Northern Illinois,2020,N,N
10,6,0,4,Conference USA,West,North Texas,2020,N,N
9,2,0,7,Big Ten,West,Northwestern,2020,N,N
12,2,0,10,FBS Independents,,Notre Dame,2020,N,N
3,1,0,2,Mid-American,East,Ohio,2020,N,N
8,1,0,7,Big Ten,East,Ohio State,2020,N,Y
11,2,0,9,Big 12,,Oklahoma,2020,N,N
11,3,0,8,Big 12,,Oklahoma State,2020,N,N
10,5,0,5,SEC,West,Ole Miss,2020,N,N
7,3,0,4,Pac-12,North,Oregon,2020,N,N
7,5,0,2,Pac-12,North,Oregon State,2020,N,N
9,5,0,4,Big Ten,East,Penn State,2020,N,N
11,5,0,6,ACC,Coastal,Pittsburgh,2020,N,N
6,4,0,2,Big Ten,West,Purdue,2020,N,N
5,3,0,2,Conference USA,West,Rice,2020,N,N
9,6,0,3,Big Ten,East,Rutgers,2020,N,N
8,4,0,4,Mountain West,West,San Diego State,2020,N,N
8,1,0,7,Mountain West,West,San Josï¿½ State,2020,N,N
10,3,0,7,American Athletic,West,SMU,2020,N,N
11,7,0,4,Sun Belt,East,South Alabama,2020,N,N
10,8,0,2,SEC,East,South Carolina,2020,N,N
10,7,0,3,Conference USA,West,Southern Mississippi,2020,N,N
9,8,0,1,American Athletic,East,South Florida,2020,N,N
6,2,0,4,Pac-12,North,Stanford,2020,N,N
11,10,0,1,ACC,Atlantic,Syracuse,2020,N,N
10,4,0,6,Big 12,,TCU,2020,N,N
7,6,0,1,American Athletic,East,Temple,2020,N,N
10,7,0,3,SEC,East,Tennessee,2020,N,N
10,3,0,7,Big 12,,Texas,2020,N,N
10,1,0,9,SEC,West,Texas A&M,2020,N,N
12,10,0,2,Sun Belt,East,Texas State,2020,N,N
10,6,0,4,Big 12,,Texas Tech,2020,N,N
6,2,0,4,Mid-American,West,Toledo,2020,N,N
11,6,0,5,Sun Belt,East,Troy,2020,N,N
12,6,0,6,American Athletic,West,Tulane,2020,N,N
9,3,0,6,American Athletic,West,Tulsa,2020,N,N
9,3,0,6,Conference USA,West,UAB,2020,N,N
10,4,0,6,American Athletic,East,UCF,2020,N,N
7,4,0,3,Pac-12,South,UCLA,2020,N,N
4,4,0,0,FBS Independents,,UMass,2020,N,N
6,6,0,0,Mountain West,West,UNLV,2020,N,N
6,1,0,5,Pac-12,South,USC,2020,N,N
5,2,0,3,Pac-12,South,Utah,2020,N,N
6,5,0,1,Mountain West,Mountain,Utah State,2020,N,N
8,5,0,3,Conference USA,West,UTEP,2020,N,N
12,5,0,7,Conference USA,West,UT San Antonio,2020,N,N
9,9,0,0,SEC,East,Vanderbilt,2020,N,N
10,5,0,5,ACC,Coastal,Virginia,2020,N,N
11,6,0,5,ACC,Coastal,Virginia Tech,2020,N,N
9,5,0,4,ACC,Atlantic,Wake Forest,2020,N,N
4,1,0,3,Pac-12,North,Washington,2020,N,N
4,3,0,1,Pac-12,North,Washington State,2020,N,N
12,7,0,5,Conference USA,East,Western Kentucky,2020,N,N
6,2,0,4,Mid-American,West,Western Michigan,2020,N,N
10,4,0,6,Big 12,,West Virginia,2020,N,N
7,3,0,4,Big Ten,West,Wisconsin,2020,N,N
6,4,0,2,Mountain West,Mountain,Wyoming,2020,N,N
13,3,0,10,Mountain West,Mountain,Air Force,2021,N,N
12,10,0,2,Mid-American,East,Akron,2021,N,N
15,2,0,13,SEC,West,Alabama,2021,N,Y
14,4,0,10,Sun Belt,West,Appalachian State,2021,N,N
12,11,0,1,Pac-12,South,Arizona,2021,N,N
13,5,0,8,Pac-12,South,Arizona State,2021,N,N
13,4,0,9,SEC,West,Arkansas,2021,N,N
12,10,0,2,Sun Belt,East,Arkansas State,2021,N,N
13,4,0,9,FBS Independents,,Army,2021,N,N
13,7,0,6,SEC,West,Auburn,2021,N,N
13,7,0,6,Mid-American,West,Ball State,2021,N,N
14,2,0,12,Big 12,,Baylor,2021,N,N
12,5,0,7,Mountain West,Mountain,Boise State,2021,N,N
12,6,0,6,ACC,Atlantic,Boston College,2021,N,N
12,8,0,4,Mid-American,East,Bowling Green,2021,N,N
12,8,0,4,Mid-American,East,Buffalo,2021,N,N
13,3,0,10,FBS Independents,,BYU,2021,N,N
12,7,0,5,Pac-12,North,California,2021,N,N
13,4,0,9,Mid-American,West,Central Michigan,2021,N,N
12,7,0,5,Conference USA,East,Charlotte,2021,N,N
14,1,0,13,American Athletic,East,Cincinnati,2021,N,N
13,3,0,10,ACC,Atlantic,Clemson,2021,N,N
13,2,0,11,Sun Belt,West,Coastal Carolina,2021,N,N
12,8,0,4,Pac-12,South,Colorado,2021,N,N
12,9,0,3,Mountain West,Mountain,Colorado State,2021,N,N
12,11,0,1,FBS Independents,,Connecticut,2021,N,N
12,9,0,3,ACC,Coastal,Duke,2021,N,N
12,5,0,7,American Athletic,East,East Carolina,2021,N,N
13,6,0,7,Mid-American,West,Eastern Michigan,2021,N,N
13,7,0,6,SEC,East,Florida,2021,N,N
12,7,0,5,Conference USA,East,Florida Atlantic,2021,N,N
12,11,0,1,Conference USA,East,Florida International,2021,N,N
12,7,0,5,ACC,Atlantic,Florida State,2021,N,N
13,3,0,10,Mountain West,West,Fresno State,2021,N,N
15,1,0,14,SEC,East,Georgia,2021,Y,N
12,9,0,3,Sun Belt,West,Georgia Southern,2021,N,N
13,5,0,8,Sun Belt,West,Georgia State,2021,N,N
12,9,0,3,ACC,Coastal,Georgia Tech,2021,N,N
13,7,0,6,Mountain West,West,Hawai'i,2021,N,N
14,2,0,12,American Athletic,West,Houston,2021,N,N
12,7,0,5,Big Ten,West,Illinois,2021,N,N
12,10,0,2,Big Ten,East,Indiana,2021,N,N
14,4,0,10,Big Ten,West,Iowa,2021,N,N
13,6,0,7,Big 12,,Iowa State,2021,N,N
12,10,0,2,Big 12,,Kansas,2021,N,N
13,5,0,8,Big 12,,Kansas State,2021,N,N
14,7,0,7,Mid-American,East,Kent State,2021,N,N
13,3,0,10,SEC,East,Kentucky,2021,N,N
13,5,0,8,FBS Independents,,Liberty,2021,N,N
14,1,0,13,Sun Belt,East,Louisiana,2021,N,N
12,8,0,4,Sun Belt,East,Louisiana Monroe,2021,N,N
12,9,0,3,Conference USA,West,Louisiana Tech,2021,N,N
13,7,0,6,ACC,Atlantic,Louisville,2021,N,N
13,7,0,6,SEC,West,LSU,2021,N,N
13,6,0,7,Conference USA,East,Marshall,2021,N,N
13,6,0,7,Big Ten,East,Maryland,2021,N,N
12,6,0,6,American Athletic,West,Memphis,2021,N,N
12,5,0,7,ACC,Coastal,Miami,2021,N,N
13,6,0,7,Mid-American,East,Miami (OH),2021,N,N
14,2,0,12,Big Ten,East,Michigan,2021,N,N
13,2,0,11,Big Ten,East,Michigan State,2021,N,N
13,6,0,7,Conference USA,East,Middle Tennessee,2021,N,N
13,4,0,9,Big Ten,West,Minnesota,2021,N,N
13,6,0,7,SEC,West,Mississippi State,2021,N,N
13,7,0,6,SEC,East,Missouri,2021,N,N
12,8,0,4,American Athletic,West,Navy,2021,N,N
12,3,0,9,ACC,Atlantic,NC State,2021,N,N
12,9,0,3,Big Ten,West,Nebraska,2021,N,N
13,5,0,8,Mountain West,West,Nevada,2021,N,N
12,9,0,3,Mountain West,Mountain,New Mexico,2021,N,N
12,10,0,2,FBS Independents,,New Mexico State,2021,N,N
13,7,0,6,ACC,Coastal,North Carolina,2021,N,N
14,5,0,9,Mid-American,West,Northern Illinois,2021,N,N
13,7,0,6,Conference USA,West,North Texas,2021,N,N
12,9,0,3,Big Ten,West,Northwestern,2021,N,N
13,2,0,11,FBS Independents,,Notre Dame,2021,N,N
12,9,0,3,Mid-American,East,Ohio,2021,N,N
13,2,0,11,Big Ten,East,Ohio State,2021,N,N
13,2,0,11,Big 12,,Oklahoma,2021,N,N
14,2,0,12,Big 12,,Oklahoma State,2021,N,N
13,7,0,6,Conference USA,East,Old Dominion,2021,N,N
13,3,0,10,SEC,West,Ole Miss,2021,N,N
14,4,0,10,Pac-12,North,Oregon,2021,N,N
13,6,0,7,Pac-12,North,Oregon State,2021,N,N
13,6,0,7,Big Ten,East,Penn State,2021,N,N
14,3,0,11,ACC,Coastal,Pittsburgh,2021,N,N
13,4,0,9,Big Ten,West,Purdue,2021,N,N
12,8,0,4,Conference USA,West,Rice,2021,N,N
13,8,0,5,Big Ten,East,Rutgers,2021,N,N
14,2,0,12,Mountain West,West,San Diego State,2021,N,N
12,7,0,5,Mountain West,West,San Josï¿½ State,2021,N,N
12,4,0,8,American Athletic,West,SMU,2021,N,N
12,7,0,5,Sun Belt,East,South Alabama,2021,N,N
13,6,0,7,SEC,East,South Carolina,2021,N,N
12,9,0,3,Conference USA,West,Southern Mississippi,2021,N,N
12,10,0,2,American Athletic,East,South Florida,2021,N,N
12,9,0,3,Pac-12,North,Stanford,2021,N,N
12,7,0,5,ACC,Atlantic,Syracuse,2021,N,N
12,7,0,5,Big 12,,TCU,2021,N,N
12,9,0,3,American Athletic,East,Temple,2021,N,N
13,6,0,7,SEC,East,Tennessee,2021,N,N
12,7,0,5,Big 12,,Texas,2021,N,N
12,4,0,8,SEC,West,Texas A&M,2021,N,N
12,8,0,4,Sun Belt,East,Texas State,2021,N,N
13,6,0,7,Big 12,,Texas Tech,2021,N,N
13,6,0,7,Mid-American,West,Toledo,2021,N,N
12,7,0,5,Sun Belt,East,Troy,2021,N,N
12,10,0,2,American Athletic,West,Tulane,2021,N,N
13,6,0,7,American Athletic,West,Tulsa,2021,N,N
13,4,0,9,Conference USA,West,UAB,2021,N,N
13,4,0,9,American Athletic,East,UCF,2021,N,N
12,4,0,8,Pac-12,South,UCLA,2021,N,N
12,11,0,1,FBS Independents,,UMass,2021,N,N
12,10,0,2,Mountain West,West,UNLV,2021,N,N
12,8,0,4,Pac-12,South,USC,2021,N,N
14,4,0,10,Pac-12,South,Utah,2021,N,N
14,3,0,11,Mountain West,Mountain,Utah State,2021,N,N
13,6,0,7,Conference USA,West,UTEP,2021,N,N
14,2,0,12,Conference USA,West,UT San Antonio,2021,N,N
12,10,0,2,SEC,East,Vanderbilt,2021,N,N
12,6,0,6,ACC,Coastal,Virginia,2021,N,N
13,7,0,6,ACC,Coastal,Virginia Tech,2021,N,N
14,3,0,11,ACC,Atlantic,Wake Forest,2021,N,N
12,8,0,4,Pac-12,North,Washington,2021,N,N
13,6,0,7,Pac-12,North,Washington State,2021,N,N
14,5,0,9,Conference USA,East,Western Kentucky,2021,N,N
13,5,0,8,Mid-American,West,Western Michigan,2021,N,N
13,7,0,6,Big 12,,West Virginia,2021,N,N
13,4,0,9,Big Ten,West,Wisconsin,2021,N,N
13,6,0,7,Mountain West,Mountain,Wyoming,2021,N,N
